Rp, Gs^Fts, Gs^Fts, Hhd, Rp, Hhd^Fts, Hhd, Gs^Fts, Gs^Fts, Rd, Hhd, Hhd, Hhd^Efm, Dd^Fts, Gs^Fts, Dd^Fts, Hhd, Gs^Fts, Dd^Fts, Dd^Fts, Dd^Fts, Dd^Fts, Dd^Fts, Dd^Fts, Dd^Fts, Dd^Fts, Wwt, Dd^Fts, Mm, Dd^Fts, Hhd, Dd^Fts, Wwt, Hhd
Gs^Fts, Gd^Fts, Gd^Fts, Hhd, Rd, Hhd, Hhd^Efm, Mm, Hhd, Mm, Hhd^Efm, Gs^Fts, Gs^Fts, Gs^Fts, Hhd, Gs^Fts, Gs^Fts, Gs^Fts, Dd^Fts, Dd^Fts, Dd^Fts, Dd^Fts, Gs^Fts, Gs^Fts, Dd^Fts, Wwt, Mm, Wwt, Wwt, Dd^Fts, Dd^Fts, Wwt, Mm, Wwt
Dd^Fts, Gs^Fts, Hhd^Fts, Hhd^Fts, Rp, Hhd^Efm, Rd, Rp, Rp, Rd, Rp, Gs^Efm, Gs^Fts, Gs^Fts, Hhd^Fts, Gs^Fts, Dd^Fts, Dd^Fts, Dd^Fts, Dd^Fts, Dd^Fts, Gs^Fts, Hhd^Fts, Hhd^Fts, Hhd^Fts, Wwt, Mm, Dd^Fts, Wwt, Hhd^Fts, Wwt, Wwt, Mm, Mm
Dd^Fts, Gs^Fts, Gs^Fts, Hhd^Fts, Hhd, Rp, Ww, Ww, Ww, Ww, Ww^Bw|r, Hhd^Efm, Gs^Fts, Gs^Fts, Hhd^Fts, Gs^Fts, Gs^Fts, Dd^Fts, Ss, Ss, Ss, Gs^Fts, Hhd^Fts, Hhd, Hhd, Wwt, Wwt, Mm, Mm, Wwt, Mm, Mm, Mm, Mm
Dd^Fts, Gs^Fts, Ww, Hhd^Efm, Ww, Ww, Hhd^Efm, Gs^Fts, Kdr, Cdr, Rp, Ww, Ww, Hhd^Fts, Ww, Hhd^Fts, Wwt, Ss, Hhd, Ss, Ww^Ewl, Ss, Ss, Hhd^Fts, Hhd^Fts, Hhd^Fts, Ww^Ewf, Mm, Mm, Mm, Hhd, Mm, Hhd, Dd^Fts
Ww, Ww, Hhd^Fts, Ww, Hhd^Fts, Hhd, Hhd, Gs^Fts, Gs^Fts, Hhd, Rd, Rd, Rp, Ww, Gs^Fts, Ww, Ww, Ss, Ss, Wwt, Wwt, Wwt, Ww, Hhd^Fts, Wwt, Wwt, Hhd, Mm, Mm, Mm, Hhd^Gvs, Hhd^Fts, Hhd, Hhd
Dd^Fts, Gs^Fts, Gs^Fts, Hhd^Fts, Hhd^Fts, Hhd^Efm, Hhd^Efm, Hhd^Fts, Gs^Ft, Gs^Fts, Gs^Fts, Gs^Fts, Rp, Dd^Fts, Gs^Fts, Gs^Fts, Hhd^Fts, Ss, Wwt, Ww^Ewl, Wwt, Wwt, Dd^Fts, Wwt, Dd^Fts, Gs^Fts, Hhd^Fts, Hhd^Fts, Gs^Fts, Hhd^Gvs, Gs^Vc, Hhd^Fts, Gs^Fts, Gs^Fts
Dd^Fts, Mm, Mm, Hhd, Hhd, Gs^Ft, Hhd, Hhd^Fts, Hhd, Gs^Fts, Dd^Fts, Dd^Fts, Rd, Gs^Fts, Hhd^Fts, Hhd^Fts, Hhd^Fts, Hhd^Efm, Hhd^Efm, Wwt, Dd^Fdw, Dd^Fts, Dd^Fts, Dd^Fts, Gs^Efm, Gs^Fts, Hhd^Fts, Hhd^Fts, Dd^Fts, Dd^Fts, Rd, Gs^Fts, Dd^Fts, Gs^Ft
Mm, Mm, Mm, Mm, Mm, Hhd^Efm, Hhd^Efm, Hhd, Dd^Fts, Gs^Efm, Gs^Fts, Dd^Fts, Rd, Gs^Fts, Gs^Fts, Hhd^Fts, Hhd^Fts, Hhd, Gs^Fts, Hhd, Gs^Fts, Dd^Fts, Dd^Fts, Dd^Fts, Dd^Fts, Dd^Fts, Dd, Dd^Fts, Rd, Rd, Dd^Fts, Rd, Rd, Dd^Fts
Mm, Wwt, Mm, Mm, Hhd^Efm, Hhd^Fts, Hhd^Fts, Hhd, Gs^Efm, Hhd, Hhd, Dd^Fts, Dd^Fts, Rp, Rd, Gs^Fts, Rd^Edb, Rd, Rd, Gs^Fts, Rd^Edb, Rd^Edb, Rd^Edb, Dd^Fts, Rd, Rd, Gs^Fts, Rd, Dd^Fts, Dd^Fts, Dd^Fts, Dd^Fts, Dd^Fts, Rd
Mm, Wwt, Wwt, Hh, Hh, Hhd^Fts, Gs^Fts, Gs^Ft, Gs^Fts, Hhd^Efm, Gs^Fts, Gs^Fts, Dd^Fts, Dd^Fts, Rp, Rd, Cdr, Mm, Mm, Rd, Gs^Ft, Ce, Gs, Rd, Dd^Fts, Dd^Fdw, Hhd, Gs^Fts, Gs^Fts, Gs^Efm, Gs^Edb, Gs^Ft, Dd^Fts, Dd^Fts
Hhd, Hh, Hh, Wwt, Hh^Efm, Hhd^Fts, Gs^Fts, Gs^Fts, Hhd, Ww^Ewf, Gs^Efm, Dd^Fts, Dd^Fts, Dd^Fts, Dd, Rp, Dd^Fts, Dd^Fts, Mm, Re^Vct, Ce, Ce, 2 Ke, Dd^Fts, Dd^Fts, Gs^Fts, Hhd^Fts, Hhd^Fts, Hhd^Fts, Gs^Ft, Gs^Fts, Gs^Fts, Hhd^Fts, Gs^Fts
Hhd, Gs^Efm, Gs^Efm, Wwt, Wwt, Gs^Fts, Gs^Fts, Hhd, Hhd^Efm, Re^Gvs, Gs^Vl, Gs^Fts, Dd^Fts, Dd^Fts, Gs^Fts, Rd, Gs^Fts, Gs^Fts, Gs^Dr, Rb, Re^Vct, Gs, Gs^Ft, Ds, Gs^Ft, Gs^Fts, Hhd, Hhd^Fts, Hhd^Fts, Gs^Fts, Hhd^Fts, Hhd^Fts, Hhd^Efm, Hhd
Gs, Gs^Fts, Gs^Fts, Hh, Wwt, Dd^Fts, Gs^Ft, Gs^Fts, Gs^Fts, Gs^Emf, Gs^Fts, Gs^Efm, Dd^Fts, Dd^Fts, Gs^Fts, Rd, Rp, Gs^Ft, Gs^Ft, Dd^Fts, Gs^Ft, Dd^Fts, Gs^Ft, Dd^Fdw, Gs^Fts, Hhd^Efm, Hhd^Fts, Hhd^Fts, Hhd, Hhd^Fts, Wwt, Hhd, Mm, Hhd
Dd^Fts, Hh, Hh, Hh, Wwt, Dd^Fts, Dd^Fts, Dd^Fts, Gs^Ft, Dd^Fts, Dd^Fts, Dd^Fts, Gs^Fts, Gs^Fts, Gs^Fts, Hhd, Rd, Hhd^Fts, Hhd^Fts, Gs^Efm, Dd^Fts, Gs^Edb, Hhd^Fts, Hhd, Hhd^Efm, Hhd, Hhd, Hhd, Hhd, Hhd, Wwt, Ww^Ewl, Mm, Mm
Re, Ss, Ss, Ss, Ss, Ss, Ss, Gs^Efm, Ss, Dd^Fts, Dd^Fts, Gs^Ft, Gs^Fts, Hhd, Mm, Hh, Rp, Hhd^Fts, Dd^Fts, Gs^Ft, Dd^Fts, Gs^Ft, Hhd^Fts, Gs^Ft, Gs^Ft, Hhd, Mm, Hhd^Efm, Mm, Mm, Mm, Mm, Hhd^Efm, Hhd
Ss, Re, Re, Ss, Ss, Ss, Ss, Ss, Ss, Ss, Ss, Dd^Fts, Gs^Efm, Hhd, Mm, Hh, Rp, Dd^Fts, Dd^Fts, Dd^Fts, Gs^Fts, Hhd^Fts, Hhd^Fts, Hhd, Mm, Mm, Mm, Mm, Hhd, Hhd, Hhd^Fts, Hhd, Hhd, Hhd
Gs^Efm, Gs, Gs^Efm, Re, Wwt^Bw\, Ss, Re, Ss, Ss, Ss, Ss, Dd^Fts, Gs^Efm, Gs, Hhd, Mm, Rd, Dd^Fts, Gs^Efm, Gs^Fts, Gs, Hhd, Hhd, Hhd^Efm, Hhd, Mm, Hhd, Mm, Hhd, Hhd^Fts, Gs^Fts, Gs^Ft, Hhd^Fts, Hhd
Rd, Ds, Ww, Wwt, Ss, Re, Ss, Re, Re, Ss, Dd^Fts, Gs, Gs, Gs, Hhd, Hhd, Rp, Gs, Gs, Gd^Fts, Gs^Efm, Hhd^Efm, Dd^Fts, Hhd, Gd^Fts, Hhd^Efm, Hhd, Hhd^Efm, Gs, Gs, Dd^Fts, Dd^Fts, Rd, Rd
Ww, Ds, Ww, Ds, Gs, Ss, Gs, Ss, Re, Gs^Efm, Dd^Fts, Dd^Fts, Gs^Eff, Gs^Eff, Gs^Eff, Gs^Efm, Rd, Mm, Gs^Efm, Gs, Gd^Fts, Dd^Fts, Gs^Eff, Gs^Eff, Gs^Eff, Hhd, Rd, Hhd, Rd, Dd^Fts, Rd, Rd, Gs^Efm, Gs
Ww, Ww, Ww, Ss, Ss, Gs^Efm, Ss, Gs, Gs^Efm, Rd, Rd, Gs, Gs^Eff, Gs^Gvs, Gs^Vh, Gs, Rp, Mm, Hhd, Gd^Fts, Gs^Eff, Gs^Eff, Re^Gvs, Re^Gvs, Rd, Rd, Gs^Fts, Rd, Hhd, Rd, Gs, Gs, Gs^Efm, Gs
Ss, Ss, Ss, Ww, Ss, Ss, Rb^Gvs, Gs, Dd^Fts, Gs, Hhd, Rd, Rd, Rd^Eff, Rd, Rp, Gs, Hhd, Gd^Fts, Dd^Eff, Gs^Eff, Re^Gvs, Rd, Rd, Gs^Fts, Gs^Fts, Dd^Fts, Gs, Ss, Gs, Hhd^Efm, Hhd, Hhd^Efm, Hhd
Ss, Ss, Ss, Ww, Ss, Ss, Ss, Gs^Vc, Ds, Dd^Fts, Rd, Rd, Ss, Ss, Ss, Kdr, Cdr, Gs^Efm, Rd, Gs^Efm, Dd^Ftd, Rd, Dd^Fts, Gs^Vh, Dd^Fts, Dd^Fts, Ww, Wwf, Wwf, Ss, Hh, Hh, Hh, Hh
Ss, Dd^Fts, Dd^Fts, Ww, Ww, Ss, Ss, Dd^Bw|, Ww, Ds, Dd^Ftd, Hhd^Efm, Ss, Wwf, Ww, Ss, Wwt^Bw/r, Rp, Ds, Rd, Rd, Rd, Dd^Fts, Dd^Fts, Dd^Fts, Dd^Fts, Ww, Dd^Fts, Dd^Fts, Ww^Ewf, Wwf, Hh, Hh, Hh
Dd^Fts, Gs, Gs^Efm, Ss, Ww, Ss, Ss, Ww, Wwf, Ww, Ww, Hhd^Efm, Hd^Efm, Ww, 3 Cdr, Wwf^Bw/r, Ww, Wwt, Ww, Ww, Ww, Ww, Ww, Dd^Fts, Dd^Fts, Dd^Fts, Ww, Gs^Efm, Hhd^Efm, Hh, Hh, Wwf, Mm, Hh
Gs, Dd^Fts, Dd^Fts, Dd^Fts, Hh, Ww, Ww, Ww, Ss, Ss, Ww, Hd^Efm, Ds, Ww, Ww^Bw|r, Cdr, Wwt, Ww, Ds, Gs^Vc, Ss, Ss, Ss, Ww, Wwf, Ww, Dd^Fts, Gs^Ft, Hhd^Efm, Gs^Ft, Hhd, Mm, Gs^Ft, Mm
Dd^Fts, Dd^Fts, Dd^Fts, Hhd^Fts, Hhd^Fts, Hh, Ds, Gg^Vwm, Rb^Gvs, Rb^Gvs, Ds, Ww, Ww, Ww, Rp, Ww, Hhd, Ds, Rd, Rd, Rb^Gvs, Rb^Gvs, Dd^Fts, Dd^Fts, Ds, Ds, Gs^Ft, Dd^Fts, Gs^Ft, Gs^Ft, Dd^Ftd, Gs^Ft, Gs^Ft, Gs^Ft
Dd^Fts, Gs^Efm, Gs^Fts, Hhd^Fts, Gs^Efm, Hhd^Efm, Rd, Hhd, Gs^Efm, Gs, Rd, Hhd^Efm, Hhd^Efm, Hhd^Efm, Rp, Hhd, Rd, Rd, Gs^Efm, Gs, Gs, Gs, Gs, Dd^Fts, Rd, Dd^Fts, Rd, Dd^Fts, Gs^Fts, Gs^Ft, Rd, Gs^Efm, Ww^Ewf, Gs^Ft
Gs, Gs^Efm, Gs, Gs, Gs, Gs, Gs^Efm, Rd, Rd, Rd, Gs^Efm, Rd, Rd, Rd, Gs, Rp, Rd, Gs, Gs^Efm, Gs^Efm, Gd^Fts, Gs^Efm, Rd, Rd, Dd^Fts, Gs^Efm, Gs^Fts, Rb, Rb, Rd, Dd^Ftd, Rb, Rb, Gs^Ft
Gs, Rd, Rd, Rd, Rd, Rd, Rd, Rd, Gs^Fts, Gs^Efm, Gs, Dd, Gs, Gs^Efm, Dd^Fts, Dd^Fts, Rd, Rp, Rd, Gd^Fts, Rp, Rd, Rp, Gd^Fts, Dd, Gs^Ft, Dd, Gs^Ft, Gs^Ft, Gs^Ft, Gs^Ft, Gs^Vc, Gs^Ft, Gs^Ft
Rd, Dd^Fts, Dd^Fts, Dd^Fts, Ds, Ds, Dd, Gs^Efm, Gs, Gs^Fts, Gs, Gs^Efm, Dd^Fts, Rd, Gs^Vl, Rd, Dd^Fts, Dd^Fts, Gd^Fts, Rp, 1 Kdr, Cdr, Cdr, Rp, Gs^Efm, Dd^Fts, Dd, Gs^Ft, Gs^Fts, Gs^Ft, Dd^Fts, Gd^Gvs, Hhd^Efm, Gs^Ft
Dd^Fts, Hhd^Fts, Hhd^Fts, Dd^Fts, Ww, Ww, Ww, Gs, Gs, Gd^Fts, Dd^Fts, Gs^Fts, Gs^Efm, Re^Gvs, Rb^Gvs, Gs^Fts, Gs^Fts, Dd, Dd^Fts, Gs, Gd^Fts, Cdr^Ebn, Gs^Ft, Rp, Rd, Gs^Ft, Gs^Ft, Dd^Fts, Gs^Efm, Dd^Fts, Gs^Ft, Gs^Ft, Gs^Ft, Hhd^Efm
Hhd^Fts, Mm, Mm, Hhd, Hhd^Efm, Ww^Ewl, Hhd^Efm, Gs^Efm, Gs, Gs^Fts, Gs^Fts, Gd^Fts, Dd^Fts, Dd^Fts, Gd^Fts, Dd, Dd^Fts, Gs^Fts, Gs^Ft, Gd^Fts, Dd^Fts, Gs^Ft, Hhd, Gd^Fts, Rp, Gs^Efm, Dd, Gs^Ft, Dd^Fts, Gd^Fts, Gs^Fts, Dd^Fts, Gs^Fts, Gs^Ft
Mm, Mm, Mm, Mm, Hhd, Hhd, Hhd, Mm, Hhd, Hhd, Gd^Fts, Gs^Fts, Gll^Fp, Gs, Gll^Fp, Dd^Fts, Gll^Fp, Gs^Ft, Gll^Fp, Dd^Fts, Gs, Gs^Ft, Rd, Hhd, Rp, Gd^Fts, Gs, Gs^Ft, Gs^Ft, Gs^Ft, Gs^Ft, Gs^Ft, Gd^Fts, Gd^Fts
