Hh, Hh, Hh, Hh, Hh, Gs^Fds, Gs^Fts, Gs^Fts, Gs, Gs^Fds, Gs, Rd, Gs^Efm, Gs, Gs^Fds, Ww, Ww, Ds, Gs, Gs, Gs, Gs, Gs, Gs^Fts, Gs^Fts, Gs, Gs, Gs^Fts, Gs^Fms, Gs, Gs, Gs, Gs^Fts, Gs
Hh, Gs^Fds, Hh, Hh, Hh, Gs^Fms, Gs^Fds, Gs, Gs^Fms, Gs, Gs^Efm, Rd, Gs, Gs, Gs, Ww, Ww, Ww, Ds, Gs^Efm, Gs, Gs^Fts, Gs^Fms, Gs, Gs^Efm, Gs^Fts, Gs^Fms, Gs, Gs, Gs^Fms, Gs^Fts, Gs, Gs, Gs^Fts
Hh, Hh, Hh, Mm, Ww, Hh, Hh, Gs^Fts, Gs^Fms, Gs, Ww, Rd, Ww, Gs^Fms, Ds, Gs^Fms, Ww, Ww, Ds, Gs, Gs^Fms, Gs, Gs, Gs^Fts, Rb^Eff, Rb^Eff, Rb^Eff, Gs^Fms, Gs^Efm, Gs, Gs, Gs^Fms, Rp, Rp
Hh, Gs^Fms, Hh, Ww^Ewf, Ww, Ww^Ewl, Wwr, Hh, Ww, Ww, Gs^Fms, Ww^Bw|, Gs, Ww, Ww, Ww^Ewl, Ww, Ww, Gs, Gs^Efm, Gs, Gs^Fts, Rb^Eff, Rb^Gvs, Rb^Gvs, Rb^Gvs, Rd, Gs^Eff, Gs, Gs^Fms, Rp, Rp, Gs^Efm, Gs^Fts
Gs^Fds, Hh, Gs^Fms, Hh, Hh, Hh, Hh, Ww, Gs, Gs^Fms, Gs^Fms, Rp, Rp, Gs^Efm, Ss, Ww, Ww, Ds, Gs, Gs^Fts, Gs^Fms, Gs^Eff, Gs^Eff, Rb^Gvs, Ww^Ewl, Gs^Vl, Gs^Eff, Rd, Rd, Rp, Gs, Rd, Gd^Fts, Gd^Fts
Gs^Fds, Hh, Gs^Fts, Hh, Hh, Gs^Fms, Hh, Hh, Hh, Gs, Gs^Fms, Gs^Efm, Rp, Gs, Ds, Ww, Ww, Ww, Ds, Gs^Efm, Gs, Gs^Fts, Gs^Fts, Gs^Eff, Gs, Gs^Eff, Rp, Rp, Gs, Gs^Fms, 1 Ke, Ce, Ce, Gs
Gs^Fds, Gs^Fms, Gs^Fms, Hh, Gs^Fts, Hh, Gs^Fms, Hh, Hh, Hh, Gs^Fts, Gs, Rp, Gs, Gs^Efm, Ds, Ww, Ww, Ww, Gs^Fts, Gs^Fts, Gs^Efm, Gs, Gs^Fms, Rp, Rp, Gs, Gs^Fts, Gs^Fts, Gs^Efm, Gs^Fts, Ce, Gs^Fts, Gs^Fts
Gs^Fds, Gs^Fts, Gs^Fts, Gs^Fms, Gs^Fms, Hh, Gs^Fts, Hh, Gs^Fts, Gs^Fts, Gs^Ft, Gs^Fms, Gs, Rp, Rp, Gs, Ww, Wo, Wo, Ww, Ww, Gs^Fts, Rp, Rp, Gs, Gs^Fts, Gs^Fts, Gs, Gs^Fms, Gs, Gs^Fts, Gs^Fts, Gs, Gd^Fts
Gs^Fts, Gs^Fms, Gs^Fms, Gs^Fms, Hh, Hh, Hh, Gs^Ft, Gs^Fts, Gs, Gs^Emf, Gs^Fts, Gs^Fts, Gs^Efm, Gs, Rp, Ww^Bw\, Ce, Rr^Vhc, Ww, Ww^Bw/, Ww^Bw/, Gs, Rd, Rd, Gs, Gs^Fts, Gs, Gs^Fts, Gs^Efm, Gs, Gs^Fts, Gs^Fms, Gs^Fts
Gs^Fds, Gs^Fts, Gs^Fms, Gs^Fts, Gs^Fts, Gs^Fts, Gs^Fts, Gs, Gs^Efm, Gs^Fts, Gs^Eff, Gs^Eff, Rb^Eff, Gs^Fts, Gs, Rp, Ww, Rp, Rp, Rp, Ch, Ww, Ww, Gs, Rd, Gs, Gs^Fts, Gs, Gs, Gs^Fts, Gs^Fts, Gs, Gs^Fts, Gd^Fts
Gs^Fds, Gs^Fts, Gs^Fms, Gs^Fts, Gs^Ft, Gs^Fts, Gs^Efm, Gs^Ft, Gs^Fts, Rb^Eff, Rb^Eff, Rb^Gvs, Rb^Eff, Gs^Vh, Gs^Efm, Rp, Ww, Ce, Rr^Vh, Ch, Kh, Ww, Ww, Ds, Rd, Gs, Gs^Efm, Gs, Gs^Fts, Gs, Hhd^Gvs, Hh, Hh, Gs
Gs^Fds, Gs^Fts, Gs^Ft, Gs^Fts, Gs^Fts, Gs^Fts, Gs^Fts, Gs, Gs, Gs^Fts, Gs, Rb^Eff, Gs^Efm, Gs^Ft, Gs^Fts, Rp, Ww, Ce, Rp, Ch, Ch, Ww, Wo, Ww, Ds, Rd, Rd, Gs^Fts, Rd, Gs^Efm, Gs^Vl, Hhd^Gvs, Hh, Hh
Gs^Fts, Gs^Fts, Gs^Ft, Gs^Ft, Gs^Fts, Gs^Fts, Gs^Fts, Gs^Ft, Gs^Fts, Gs^Efm, Gs, Gs^Ft, Gs^Fts, Gs, Gs, Rp, Ww^Bw/, Rp, Ce, Rr^Vh, Ww^Bw\, Ww, Wo, Ww, Ds, Gs, Hh, Rd, Hh, Hhd^Gvs, Hh, Hh, Hh, Hh
Gs^Fts, Gs^Fds, Gs^Fts, Gs^Fts, Gs^Fts, Gs^Emf, Gs^Ft, Gs^Fts, Gs^Efm, Gs^Ft, Gs^Fts, Gs, Gs^Efm, Gs^Fts, Rp, Rp, Hh, Ww, Ww, Ce, Ww, Wo, Ww, Ww^Ewl, Ds, Hh, Rd, Rd, Gs, Hh, Hh, Hh, Hh, Hh
Gs^Fds, Gs^Fts, Gs^Fts, Gs^Fts, Rb^Gvs, Rb^Gvs, Gs^Efm, Gs^Fts, Gs, Gs, Gs^Fts, Gs, Rp, Rp, Gg^Efm, Rd, Rd, Hh^Efm, Hh, Ww, Ww, Ww, Hd, Ss, Hh, Rd, Rd, Hh, Gs, Hh, Hh, Hh, Gs^Fts, Hh
Gs^Fts, Gs^Fts, Gs^Fts, Gs^Fts, Rd, Gs, Gs^Vl, Gs^Fts, Rp, Gs^Ft, Rp, Gs^Fts, Rp, Gg^Vwm, Rb^Gvs, Gs^Ft, Gs^Efm, Rd, Hh, Hh^Efm, Ww, Ww, Hd^Efm, Ss, Hd, Gs^Efm, Rd, Gs, Hh, Hh, Gs^Fts, Hh, Gs^Fms, Gs^Fts
Gs^Fts, Gs^Fts, Gs^Fts, Gs, Gs^Fts, Rd, Rp, Rp, Gs^Fts, Rp, Gs^Fts, Rp, Ss, Gs^Fts, Dd^Ftd, Rb^Gvs, Rd, Rd, Ss, Ww, Ww, Ww, Ww, Mm, Wwf, Hd, Wwf, Hh, Mm, Hh, Mm, Gs^Fts, Mm, Gs^Fts
Gs^Fms, Gs^Fts, Gs^Fts, Gs, Rp, Rp, Ss, Ss, Ww^Ewl, Ww^Ewl, Ww, Ss, Ss, Ss, Ss, Ds, Ww, Gs^Vh, Ww^Bw\, Wo, Wo, Ww, Wo, Ds^Esd, Ww, Wwf, Ds, Wwf, Ww, Mm, Gs^Fts, Mm, Hh, Hh
Gs^Fts, Gs^Fts, Rp, Rp, Gs^Efm, Ss, Ww^Ewf, Ww, Ww, Hh, Ww, Ww, Ww, Ww, Ww, Ww, Ww, Ww, Ww, Wo, Wo, Wo, Ww, Ww, Ds, Ds, Gs^Fts, Gs^Fts, Ww, Gs^Fts, Gs^Fts, Gs^Fts, Hh, Gs^Fts
Rp, Rp, Gs, Gs^Fts, Ww^Ewl, Dd^Ftd, Ww, Wo, Ww, Ww, Ss^Vhs, Ww, Ss, Ww, Ss, Ww, Ww^Ewf, Ww, Ww, Ww, Ww, Ww, Gs^Fts, Rd, Gs^Fts, Gs^Fts, Gs^Fts, Hh, Gs^Fts, Ww, Ww, Ww, Wwt, Hh
Dd^Ftd, Gs^Efm, Ww, Ww, Ww, Ww, Ww, Ww, Ss, Gs^Fdw, Ww^Ewf, Ss, Ss, Ss, Gs^Fts, Gs^Fts, Gs^Edt, Ds, Gs^Fts, Gs^Fts, Gs^Fts, Gs^Fts, Rd, Rd, Gs^Ft, Gs^Fts, Gs^Efm, Hh, Hh, Gs^Fts, Gs^Ft, Gs^Fts, Ds, Ww
Ww^Ewf, Ww, Wo, Wo, Ss, Ss, Gs^Fts, Ss, Ss, Ss, Ss, Ss, Ss, Gs^Fts, Gs^Ft, Cer, Gs^Edt, Rd, Gs^Ft, Gs^Fts, Rd, Gs, Gs^Fts, Gs^Fts, Gs^Ft, Gs^Fts, Hh, Hh, Gll^Ftr, Gs^Ft, Gs^Ft, Hh, Ds, Wwt
Ww, Wo, Ww, Ss, Ww^Ewl, Hh, Hh, Gs^Fts, Hh, Ss, Ss, Ss, Gs^Fts, Gs^Fts, Rb, Gs^Emf, Gd, Rd, Rd^Edb, Rd, Gs^Fts, Gs^Fts, Gs^Fts, Gs^Fts, Gs^Fts, Gs^Ft, Hh, Gll^Ftr, Mm, Gll^Ftr, Hh, Hh, Wwt, Wwt
Wo, Wo, Ww, Ss, Gs^Fts, Hh, Hh, Hh, Gs^Fts, Gs^Fts, Gs^Efm, Gs^Fts, Gs^Fts, Gs^Ft, Gs^Fts, Gd^Edb, Gs^Edb, 2 Ko, Co, Rd^Edt, Gd^Vo, Gs^Ft, Gs^Ft, Gs^Efm, Gs^Ft, Gs^Ft, Hh, Gs^Vc, Ww^Ewl, Wwt, Wwt, Hh, Wwt, Hh
Ww, Ww, Ww, Dd^Ftd, Gs^Fts, Hh, Gs, Hh, Hh, Gs^Fts, Gs^Fts, Gs, Gs^Ft, Gs, Gs^Fts, Gs^Ft, Gs^Edb, Co, Co, Rd, Gd^Vo, Gs^Edt, Gs^Efm, Gs^Fts, Hh, Hh, Gs^Ft, Ss, Hh, Hh, Hh, Wwt, Hh, Hh
Gs, Gs, Ss, Ww^Ewl, Gs^Fts, Gs^Fts, Gs^Fts, Gs^Fts, Hh, Gs^Fts, Gs^Fts, Gs, Gs, Gs^Fts, Gs^Ft, Gs^Ft, Gs^Ftp, Gs^Ftp, Gs^Fts, Rd^Edt, Gs^Fts, Gs^Ft, Gs^Fts, Gs^Fts, Hh, Gs^Ft, Gs^Ft, Gs^Ft, Gs^Ft, Hh, Hh, Hh, Hh, Hh
