Gs^Fds, Gs^Fds, Gs^Fds, Gs^Fds, Gs^Fds, Gs^Fds, Gs^Fds, Gs^Fds, Gs^Fds, Gs^Fds, Gll^Ftr, Gs^Fds, Gll^Ftr, Gs^Fds, Gs^Fds, Gll^Ftr, Gll^Ftr, Gll^Ftr, Gll^Ftr, Gs^Fds, Gll^Ftr, Gg^Fp
Gs^Fds, Gs^Fds, Gll^Ftr, Gll^Ftr, Gll^Ftr, Gs^Fds, Gs^Fds, Gs^Fms, Gs^Efm, Gs^Fds, Gs^Fds, Gll^Ftr, Gs^Fds, Gs^Fds, Gs^Fds, Gs^Fds, Gs^Fds, Gs^Fds, Gs^Fds, Gll^Ftr, Gll^Ftr, Gll^Ftr
Gs^Fds, Gs^Fds, Gs^Efm, Gll^Ftr, Gll^Ftr, Gll^Ftr, Gll^Ftr, Gs^Fds, Gs^Fds, Gs^Fds, Gs^Fds, Gs^Fds, Gs^Fds, Gs^Fds, Gs^Fms, Gs^Efm, Ww^Ewf, Gs^Fds, Gs^Fds, Gll^Ftr, Gg^Ve, Gll^Ftr
Gs^Fds, Gs^Fds, Gg^Ve, Ww^Ewf, Gll^Ftr, Gg^Fet, Gs^Fds, Gll^Ftr, Cv, 3 Kv, Cv, Gs^Fds, Gs^Fds, Gs^Fds, Gs^Fds, Gs^Fds, Gll^Ftr, Gll^Ftr, Gs^Fds, Gg^Fet, Gs^Efm, Gll^Ftr
Gs^Fds, Gs^Fds, Gs^Fds, Gll^Ftr, Gs^Fds, Gs^Fds, Cv, Gs^Fds, Ww^Ewf, Gg^Ve, Ww^Ewf, Gs^Fds, Cv, Gs^Fds, Gs^Fds, Gs^Fds, Gll^Ftr, Gll^Ftr, Gs^Fds, Gs^Fds, Gs^Fds, Gs^Fds
Gs^Fds, Gs^Fds, Gs^Fds, Gs^Fds, Gs^Fds, Gs^Efm, Cv, Gg^Ve, Ww^Ewf, Gg^Fet, Ww^Ewf, Gg^Ve, Cv, Gs^Fds, Gg^Efm, Gs^Fds, Gs^Efm, Gs^Fds, Gs^Fds, Gll^Ftr, Gll^Ftr, Gll^Ftr
Gs^Fds, Gs^Fds, Gll^Ftr, Gll^Ftr, Gs^Fds, Gs^Fds, Gs^Fds, Gs^Fds, Cv, Kv, Cv, Gs^Fds, Gs^Fds, Gs^Fds, Gs^Fds, Gs^Fds, Gs^Fds, Gg^Ve, Gs^Efm, Gll^Ftr, Gll^Ftr, Gs^Fds
Gs^Fds, Gs^Fds, Gs^Fds, Gll^Ftr, Gs^Fds, Gs^Fms, Gs^Efm, Gs^Fds, Gs^Fds, Gg^Bsb|, Gs^Fds, Gs^Fds, Gs^Fds, Gs^Fds, Gs^Fds, Gs^Fds, Ww^Ewl, Ww^Ewf, Gs^Fds, Gg^Edp, Gs^Fds, Gll^Ftr
Rp, Gs^Fds, Gs^Fds, Gs^Fds, Gs^Fds, Gs^Fds, Gs^Fds, Gs^Fds, Gs^Fds, Rrc, Gs^Fds, Gll^Ftr, Gll^Ftr, Gll^Ftr, Gs^Fds, Gs^Fds, Gs^Fms, Gs^Fds, Gs^Fds, Gs^Fds, Gs^Fds, Gs^Fds
Gs^Fds, Rp, Rp, Rp, Rp, Gs^Fds, Rp, Gs^Fds, Gg, Rrc, Gs^Fds, Gs^Fds, Rp, Gs^Fds, Rp, Gg^Efm, Gg^Efm, Gs^Fds, Gs^Fds, Gll^Ftr, Gs^Fds, Gs^Fds
Ww, Gs^Fds, Ss, Ss, Gs^Fds, Rp, Gs^Fds, Rp, Rrc^Bsb\, Rrc, Ww^Bsb/, Rp, Ds, Rp, Ww^Ewl, Rp, Rp, Gs^Fds, Gs^Fds, Gs^Fds, Gs^Fds, Gs^Fds
Ww, Ww, Ww^Ewf, Ww, Ww, Ww, Ww, Ww, Ww, Cvr, Wo, Ww, Ww, Ww, Ds, Ss, Ss, Rp, Rp, Gg, Rp, Gg
Gs^Ft, Gs^Ft, Gg^Ftp, Gg^Ftp, Ww, Wot, Wot, Wot, Ww, Ww^Bsb|, Ww^Ewf, Wot, Wot, Ww, Ww, Ds, Ds, Gs^Fds, Gs^Fds, Rp, Gs^Fds, Rp
Ww, Ww, Ww, Ww, Wot, Wot, Ss, Wot, Cvr, Ww^Bsb|, Cvr, Ww, Wot, Wot, Wot, Ww, Wo, Wo, Ww, Ds, Ww, Ds
Wot, Ww^Ewf, Wot, Wot, Wot, Ww^Ewl, Wot, 4 Kvr, Cvr, Cvr, Cvr, Gg^Ve, Wot, Wot, Gg^Fet, Wot, Wot, Ww, Ww, Ww, Ww, Ww
Wot, Wot, Wot, Wot, Wot, Wot, Wot, Wot, Ww, Ww^Bsb|, Ww, Ww, Wot, Wot, Wot, Hh^Efm, Wot, Wot, Wot, Ww, Wot, Ww
Wot, Wot, Ww, Wot, Ww, Wot, Wot, Wot, Ww, Ww^Bsb|, Ww, Ww, Wot, Wot, Wot, Wot, Wot, Wot, Ww, Ww, Wot, Wot
Ww, Ww, Ww, Ww, Ds, Wwr, Gs^Fds, Ww, Ds^Bsb/, Cvr, Ds^Bsb\, Wwr, Wwr, Wot, Ww, Ww, Wwr, Wot, Ww, Wot, Wot, Wot
Ww, Ww, Ds, Ds, Gs^Ftp, Gs^Fds, Rp, Rp, Re^Edb, Re, Re^Edt, Rp, Rp, Ds, Gs^Ftp, Ds, Ds, Ww, Ww, Wwr, Wwr, Ww
Ds, Ds, Gs^Fds, Gs^Ftp, Rp^Edb, Rp, Ke, Ce, Re^Edt, Re, Gll^Fdw, Ce, Gll^Fdw, Rp, Rp^Edb, Gs^Ftp, Gs^Ftp, Rd, Ds, Ww, Ww, Wwt
Gs^Ftp, Gs^Ftp, Rp, Rp, Gs^Ft, Gll^Fdw, Gll^Fdw, Re, Ce, Ce, Ce, Gll^Fdw, Gll^Fdw, Gs^Fms, Gg^Edb, Rp, Rp, Rd, Gs^Ft, Gs^Ftp, Gs^Ftp, Ds
Rp, Rp, Gs^Fds, Gs^Ft, Gll^Fdw, Gs^Ft, Re^Edb, Re, Re^Edt, 2 Ke, Re, Re^Edt, Re^Vct, Gll^Ftr, Gs^Fds, Gs^Fds, Gs^Fds, Rp, Rp, Gs^Ft, Gs^Ft, Gs^Ftp
Gs^Fds, Gs^Ft, Gs^Fms, Gs^Ft, Gs^Fds, Re^Edb, Gll^Fdw, Re^Vct, Re^Vct, Re^Edb, Re^Edb, Re^Vct, Gll^Edt, Gs^Fds, Gs^Ft, Gs^Ft, Gs^Fds, Gs^Fds, Gs^Fds, Rp, Rp, Gs^Ft
Gs^Ft, Gs^Ft, Gs^Fds, Gll^Ftr, Gll^Ftr, Re^Edt, Gd^Fts, Gll^Edb, Gll^Fdw, Re^Edb, Gs^Fds, Gs^Fds, Gs^Fds, Gs^Fds, Gs^Fds, Gs^Ft, Gs^Fds, Gs^Fds, Gs^Fds, Gs^Efm, Gs^Fds, Rp
Gs^Ft, Gs^Ft, Gll^Ftr, Gs^Fds, Gll^Fmw, Rd, Gs^Ecf, Gll^Ftr, Gs^Fds, Gs^Fds, Gs^Fds, Gs^Fds, Gs^Fds, Gs^Fds, Gs^Ft, Gs^Ft, Gs^Fds, Gs^Fds, Gs, Gs^Ft, Gs^Fds, Gs^Fds
Gs^Fds, Gs^Fds, Gs^Fds, Gll^Ftr, Gs^Fds, Gll^Ftr, Gll^Ftr, Gll^Ftr, Gs^Ft, Gs^Ft, Gll^Ftr, Gll^Ftr, Gll^Ftr, Gs^Fds, Gs^Fds, Gs^Fds, Gs^Ft, Gs, Gs^Ft, Gs^Fds, Gll^Ftr, Gll^Ftr
Gs^Fds, Gs^Ft, Gs^Fds, Gs^Fds, Gs^Fds, Gs^Fds, Gll^Ftr, Gs^Fds, Gs^Ft, Gs^Ft, Gs^Ft, Gs^Fds, Gs^Fds, Gs^Fds, Gs^Fds, Gs^Fds, Gs^Ft, Gs, Gs^Fds, Gs^Efm, Gs^Vht, Ww^Ewf
Gs^Fds, Gs^Ft, Gs^Ft, Gs^Ft, Gs^Fds, Gs^Fds, Gs^Fds, Gs^Fds, Gs^Fds, Gs^Fds, Gs^Fds, Gs^Fds, Gll^Ftr, Gs^Fds, Gg^Fet, Gs^Fds, Gs^Ft, Gs, Gs^Fds, Gs^Ft, Gs^Ft, Gs^Fds
Gll^Ftr, Gs^Ft, Gs^Fds, Gs^Fds, Gll^Ftr, Gll^Ftr, Gll^Ftr, Gs^Fds, Gs^Fds, Gs^Fds, Gs^Fds, Gs^Fds, Gll^Ftr, Gs^Fds, Gs^Fds, Gs^Fds, Gs^Fds, Gs^Efm, Gs^Ft, Gs^Fds, Gll^Ftr, Gll^Ftr
Gll^Ftr, Gs^Fds, Gs^Ft, Gll^Ftr, Cdr, Gll^Ftr, Gs^Fds, Gs^Fds, Gs^Fds, Gg^Fet, Gs^Fds, Gll^Ftr, Gll^Ftr, Gs^Fds, Gs^Fds, Gs^Fds, Gs^Fds, Gs^Ft, Gs^Fds, Gs^Fds, Gll^Ftr, Gll^Ftr
Gg, Gll^Ftr, Gs^Fds, Cdr, Kdr, Cdr, Gs^Fds, Gs^Fds, Gs^Fds, Gs^Fds, Gs^Fds, Gll^Ftr, Gs^Fds, Gs^Fds, Gs^Fds, Gs^Fds, Gs, Gs^Efm, Gs^Ft, Gs^Fds, Gs^Fds, Gll^Ftr
Gs^Fds, Gll^Ftr, Gs^Fds, Gs^Fds, Gs^Fds, Gll^Ftr, Gll^Ftr, Gll^Ftr, Gs^Fds, Gs^Fds, Gs^Ft, Gs^Fds, Gll^Ftr, Gs^Fds, Gll^Ftr, Gs^Ft, Gs^Efm, Gs^Fds, Ss, Ww, Ww, Gll^Ftr
Gs^Fds, Gll^Ftr, Gll^Ftr, Gll^Ftr, Gs^Fds, Gs^Efm, Gll^Ftr, Gs^Fds, Gll^Ftr, Gll^Ftr, Gs^Fds, Gs^Vht, Gs^Ft, Gs^Fds, Gll^Ftr, Gll^Ftr, Gs, Gs^Ft, Gg, Ww^Ewf, Gll^Ftr, Gll^Ftr
Gll^Ftr, Gs^Fds, Gs^Fds, Gs^Fds, Gs^Fds, Gs, Gs^Fds, Gs^Fds, Gs^Fds, Gll^Ftr, Gs^Fds, Rb^Gvs, Gs^Fds, Gs^Fds, Gs^Fds, Gll^Ftr, Gs^Ft, Gs^Fds, Gs^Fds, Gll^Ftr, Gll^Ftr, Gll^Ftr
Gs^Fds, Gs^Fds, Gs^Fds, Gs^Fds, Gs^Fds, Gll^Ftr, Gs^Fds, Gs^Fds, Gs^Fds, Gs^Fds, Gs^Fds, Gs^Fds, Gs^Fds, Gs^Fds, Gs^Fds, Gs^Ftp, Gll^Ftr, Gs^Efm, Gs^Fds, Gs^Ft, Gs^Fds, Gs^Fds
Gs^Fds, Gs^Fds, Gs^Fds, Gs^Fds, Gs^Fds, Gs^Fds, Gs^Fds, Gs^Ft, Gs^Efm, Gs^Fds, Gs^Fds, Gs^Fds, Gs^Fds, Gs^Fds, Gs^Fds, Gll^Ftr, Gs^Efm, Gs, Gs^Ft, Gs^Fds, Gll^Ftr, Gs^Fds
Gs^Fds, Gs^Fds, Gll^Ftr, Gs^Fds, Gs^Fds, Gs^Fds, Gs^Fds, Gs^Fds, Gs^Fds, Gs^Fds, Gs^Fds, Gll^Ftr, Gs^Fds, Gll^Ftr, Gs^Fds, Gs^Fds, Gs^Fds, Gs^Fds, Gs^Fds, Gs^Fds, Gs^Fds, Gll^Ftr
Gs^Fds, Gs^Ft, Gs^Fds, Gs^Fds, Gll^Ftr, Gs^Fds, Gs^Fds, Gs^Fds, Gs^Ft, Gs^Fds, Gs^Fds, Gs^Ft, Gs^Ft, Gs^Fds, Gll^Ftr, Gs, Gs^Fds, Gs^Fds, Gs^Fds, Gs^Fds, Gs^Fds, Gll^Ftr
Gs^Fds, Gs^Fds, Gs^Fds, Gs^Fds, Gs^Fds, Ww^Ewf, Gs^Gvs, Gs^Ft, Gs^Ft, Gs^Fds, Gs^Efm, Gs^Fds, Gs^Fds, Gll^Ftr, Gs^Efm, Gs^Fds, Gs^Fds, Gs^Fds, Gs^Fds, Gll^Ftr, Gs^Fds, Gs^Fds
Gs^Fds, Gs^Fds, Gs^Fds, Gs^Fds, Gs^Fds, Gs^Vht, Gs^Fds, Gs^Ft, Gs^Fds, Gs^Fds, Gs^Fds, Gs^Fds, Gll^Ftr, Gs^Ft, Gs^Fds, Gs^Fds, Gll^Ftr, Gll^Ftr, Gll^Ftr, Gll^Ftr, Gs^Fds, Gs^Fds
Gs^Fds, Gs^Ft, Gs^Fds, Gs^Fds, Gll^Ftr, Gs^Fds, Gll^Ftr, Gs^Fds, Gs^Fds, Gs^Fds, Gs^Fds, Gs^Ft, Gll^Ftr, Gs, Ce, Gs^Fds, Ww^Ewf, Gs^Vht, Gll^Gvs, Gll^Ftr, Gs^Ft, Gs^Fds
Gs^Fds, Gs^Ft, Gll^Ftr, Gs^Fds, Gs^Fds, Gs^Ft, Gs^Ft, Gll^Ftr, Gs^Ft, Gs^Fds, Gs^Fds, Gs^Fds, Gs, 1 Ke, Ce, Ce, Gs, Gs^Efm, Gs^Ft, Gs^Ft, Gs^Fds, Gs^Fds
Gs^Fds, Gll^Ftr, Gll^Ftr, Gs^Fds, Gs^Fds, Gs^Fds, Gs^Fds, Gll^Ftr, Gs^Fds, Gs^Fds, Gs^Fds, Gs^Fds, Gs, Gs^Ft, Gll^Ftr, Gs^Ft, Gs^Ft, Gs^Ft, Gs^Fds, Gs^Fds, Gs^Fds, Gs^Fds
Gs^Fds, Gs^Fds, Gll^Ftr, Gll^Ftr, Gll^Ftr, Gs^Fds, Gs^Fds, Gll^Ftr, Gs^Fds, Gs^Fds, Gs^Fds, Gll^Ftr, Gg, Gs^Ft, Gs^Fds, Gll^Ftr, Gs^Ft, Gs^Fds, Gs^Fds, Gll^Ftr, Gll^Ftr, Gll^Ftr
