Gll^Ftr, Gs^Ft, Gs^Ft, Gs^Ft, Gs^Ft, Gs^Ft, Gs^Ft, Gs^Ft, Gs^Ft, Gs^Ft, Gs^Ft, Gs^Ft, Re, Gll^Ftr, Gll^Ftr, Gll^Ftr, Gll^Ftr, Gll^Ftr, Gll^Ftr, Gll^Ftr, Gll^Ftr, Gll^Ftr, Gs^Ft, Gs, Hh, Re^Efm, Gs^Ft, Gs^Ft
Gs^Ft, Gs^Ft, Gs^Ft, Gll^Ftr, Gs^Ft, Gll^Ftr, Gs^Ft, Gs^Fet, Gll^Ftr, Gll^Ftr, Gs^Ft, Gs^Ft, Re^Efm, Gll^Ftr, Re^Efm, Re^Efm, Re^Efm, Re^Efm, Re^Efm, Gll^Ftr, Gs^Fet, Gs^Ftp, Re^Efm, Gll^Ftr, Re^Efm, Re^Efm, Gs^Ftp, Gll^Ftr
Gs^Ft, Gs^Fet, Gs^Ft, Gs^Ve, Re^Efm, Gs, Gs^Ftp, Gs^Efm, Re^Efm, Re, Re^Efm, Re^Efm, Gs^Ftp, Re^Efm, Gs^Ve, Gs^Fet, Gs^Ft, Hh^Ft, Gs^Efm, Re^Efm, Re^Efm, Re^Efm, Gs^Efm, Re^Efm, Ds, Re^Efm, Re^Efm, Gll^Ftr
Re, Gs^Efm, Re^Efm, Re, Gs, Re^Efm, Re, Re^Efm, Gs^Efm, Hh, Gs^Fet, Gs, Gs^Ftp, Gs^Efm, Ww^Ewf, Gs^Ft, Hh^Ft, Hh^Ft, Hh^Ft, Hh, Gs^Fet, Gs^Ftp, Ss, Ss, Ww^Ewf, Ss, Re^Efm, Gs
Gs^Ftp, Re^Efm, Gs^Ft, Gs^Ft, Gll^Ftr, Gs^Ft, Gs^Efm, Gs^Ve, Hh, Hh, Hh, Mm, Gs^Ftp, Gs^Ftp, Gs^Ft, Gll^Ftr, Gll^Ftr, Mm, Gll^Ftr, Hh, Gs^Ftp, Gs^Ftp, Ss, Ss, Ww, Ww, Re^Efm, Gs
Gs^Ftp, Re^Efm, Gs^Ft, Gs^Ft, Gs^Ft, Gs^Ft, Gs^Ft, Hh, Gll^Ftr, Gll^Ftr, Mm, Mm, Mm, Hh, Gll^Ftr, Hh, Mm, Mm, Mm, Hh, Hh, Hh, Ss, Gg^Fet, Ww^Ewf, Cv, Re^Efm, Gs^Ft
Re^Efm, Re^Efm, Re^Efm, Gs^Efm, Gll^Ftr, Gs^Ft, Mm, Mm, Gll^Ftr, Mm, Mm, Gll^Ftr, Mm, Hh, Gll^Ftr, Hh^Ft, Hh^Ft, Gs^Ft, Mm, Hh^Ft, Hh, Hh, Ds, Ww^Ewl, Cv, 2 Kv, Re^Efm, Gs^Ft
Gs^Efm, Gs^Fet, Ce, 1 Ke, Ce, Mm, Mm, Mm, Gg^Fet, Mm, Mm, Mm, Gs^Ve, Gs^Ft, Gs^Ft, Gs^Ft, Gs^Ft, Gs^Fet, Hh^Ft, Hh^Ft, Hh, Gs^Ft, Gs^Ft, Cv, Re^Efm, Re^Efm, Gs^Efm, Gs^Ft
Gs^Ft, Hh^Ft, Gs^Ft, Ce, Hh, Mm, Mm, Gll^Ftr, Mm, Gll^Ftr, Gll^Ftr, Mm, Gll^Ftr, Gll^Ftr, Gll^Ftr, Gll^Ftr, Gs^Ft, Gs^Ft, Gs^Ft, Gs^Ft, Gs^Ft, Gs, Re^Efm, Re^Efm, Gs^Fet, Gs, Gs^Efm, Gs
Hh^Ft, Gll^Ftr, Gll^Ftr, Gll^Ftr, Mm, Mm, Mm, Gll^Ftr, Mm, Gll^Ftr, Mm, Mm, Mm, Hh^Ft, Gs^Ft, Gs^Ft, Gs^Efm, Gs, Gs, Gs^Ve, Re^Efm, Re^Efm, Gs, Gs^Ftp, Gs, Gs^Ft, Gs^Ft, Gs^Ft
Gll^Ftr, Gll^Ftr, Gll^Ftr, Gll^Ftr, Gll^Ftr, Mm, Gll^Ftr, Hh, Hh, Hh, Mm, Mm, Mm, Hh, Gs^Ft, Gs, Re^Efm, Gs^Ftp, Gs, Gs^Efm, Re^Efm, Gs^Fet, Gs^Ft, Gs^Efm, Gs^Ft, Gs^Ft, Gs^Ft, Gs^Fet
Hh^Ft, Hh, Gll^Ftr, Gll^Ftr, Hh, Hh, Hh, Hh^Ft, Hh, Hh, Gs^Ve, Hh, Hh, Gs^Efm, Re^Efm, Re^Efm, Gs^Efm, Re^Efm, Re, Re^Efm, Re, Gs^Ft, Gs^Ft, Hh, Hh, Hh, Gs^Ft, Gs^Ft
Gll^Ftr, Gll^Ftr, Gll^Ftr, Hh^Ft, Hh^Ft, Gs^Ft, Gs^Ft, Gs^Ft, Hh^Ft, Ww^Ewf, Re, Re^Efm, Re^Efm, Gs^Ve, Re^Efm, Gs^Ve, Gs^Ft, Gs^Ft, Gs, Gs^Ve, Re^Efm, Gs^Efm, Gs^Ft, Hh, Hh, Hh, Hh, Hh
Hh, Gll^Ftr, Hh^Ft, Mm, Gs^Ft, Gs^Ft, Gs^Fet, Gs^Ft, Gs^Ft, Gs^Ve, Re^Efm, Gs^Ft, Gs^Ft, Re^Efm, Gs^Ft, Gs^Ft, Gs^Fet, Gs^Ft, Gs^Efm, Gs^Ft, Re^Efm, Gs, Gs^Fet, Gs, Gs^Ft, Gs^Ft, Hh, Gs^Ft
Hh, Mm, Mm, Gll^Ftr, Gs^Ft, Gs^Ft, Gs^Ft, Hh^Ft, Gs^Ft, Gs^Ft, Gs^Efm, Re^Efm, Gs^Ft, Gs^Ft, Gs^Ve, Gs^Ft, Gs^Ft, Gs^Ft, Gs^Ft, Gs^Ft, Gs^Ft, Re^Efm, Hh^Ft, Gs^Ft, Gs^Ft, Gs^Fet, Gs^Ft, Mm
Mm, Mm, Mm, Mm, Mm, Hh^Ft, Hh^Ft, Gll^Ftr, Gs^Ft, Gs^Fet, Gs, Re, Gs^Ft, Gs^Ft, Gs^Ft, Gs^Fet, Gs^Ft, Gs^Ft, Gs^Ft, Gs^Fet, Gs^Ft, Re, Hh, Hh^Ft, Gs^Ft, Mm, Hh, Mm
Mm, Mm, Mm, Mm, Mm, Gll^Ftr, Gll^Ftr, Gll^Ftr, Gll^Ftr, Hh, Re^Efm, Re^Efm, Gs^Ve, Gs^Ft, Gs^Ft, Gs^Ft, Gs^Ft, Gs^Fet, Gs^Ft, Gs^Ft, Gs^Ft, Re^Efm, Re^Efm, Hh, Hh, Mm, Mm, Mm
Mm, Mm, Mm, Hh, Hh, Hh, Gll^Ftr, Gll^Ftr, Hh, Hh, Re, Gs^Ft, Gs^Ft, Gs^Ft, Gs^Fet, Gs^Ft, Gs^Ft, Gs^Ft, Ds, Ss, Ww, Ss, Gs^Ft, Re, Re^Efm, Gs^Ftp, Mm, Mm
Mm, Mm, Mm, Hh, Hh^Ft, Gs^Ft, Gs^Ft, Hh, Hh, Gll^Ftr, Re^Efm, Gs^Ft, Gs^Ft, Gs^Ft, Gs^Ft, Gs^Ft, Gs^Ft, Gs^Ft, Ds, Ww, Ww, Ww, Ww, Ss, Ss, Re^Efm, Re^Efm, Hh^Ft
Mm, Mm, Mm, Hh, Hh, Gs^Fet, Gs^Ft, Gs, Gs^Ft, Re^Efm, Gll^Ftr, Gs, Gs^Fet, Gs^Ft, Gs^Ft, Gs^Ft, Gs^Ft, Ss, Ww, Ww, Ww, Ww, Wo, Wo, Ds, Hh, Re^Efm, Hh^Ft
Ww, Ww^Ewl, Hh, Hh^Ft, Gs^Ft, Gs^Ft, Gs, Gs^Efm, Re^Efm, Re, Hh, Hh^Ft, Hh^Ft, Mm, Mm, Mm, Ss, Ww, Ww, Wo, Ww, Ww, Ww, Ww, Ds, Re^Efm, Hh^Ft, Mm
Gs, Ww, Ww, Ds, Gs^Fet, Gs^Efm, Gs^Ftp, Re, Gs^Fet, Hh, Mm, Mm, Mm, Mm, Mm, Mm, Mm, Ww, Wo, Wo, Wo, Ww, Ww, Ww, Ds, Re, Hh, Gs
Gs^Ft, Gs^Ft, Ww, Ds, Gs^Efm, Gs^Ftp, Re^Efm, Re^Efm, Rb, Cdr, Rb^Dr, Mm, Cdr, Mm, Mm, Mm, Mm, Ww, Wo, Wo, Ww, Ww, Ww, Ds, Gs, Re^Efm, Ds, Gs
Gs, Ss, Ww, Ds, Gs^Ft, Gs^Ftp, Re, Gs^Ft, Hh, Rb, Mm, Rb, 3 Kdr, Cdr, Mm, Mm, Mm, Ss, Ww, Ww, Ww, Ww, Ww, Ww^Bw\, Gs^Efm, Gs^Fet, Ds, Ww
Ww, Ww, Gs^Ft, Hh, Gs^Ve, Re^Efm, Gs^Ft, Gs^Ve, Mm, Mm, Mm, Rb, Mm, Mm, Mm, Mm, Gll^Ftr, Gs^Ft, Ww, Ww, Ww, Ww, Ss, Gs^Fet, Gs^Ve, Gs^Efm, Gg^Fet, Ww
Ww, Gs^Ft, Gs^Ft, Hh, Hh, Re^Efm, Re^Efm, Gll^Ftr, Gll^Ftr, Gs^Fet, Mm, Mm, Mm, Mm, Mm, Mm, Gll^Ftr, Gs^Ft, Ww, Ww, Ds, Ss, Gs^Ft, Gs^Efm, Gg^Fet, Rb^Gvs, Ww, Ww
Ww, Hh^Ft, Hh, Gs^Ft, Hh, Gs^Ft, Re^Efm, Gs^Ft, Gs^Efm, Gll^Ftr, Ds, Ds, Ww, Hh, Mm, Hh, Hh, Gs^Ft, Ww, Ss, Ss, Gs^Ft, Re^Efm, Re, Gs^Efm, Ss, Ww, Ww
Ds, Ww, Ss, Ss, Gs^Ve, Gs^Ft, Re^Efm, Gs^Ve, Ds, Gs^Ft, Gs^Ft, Ww, Hh^Ft, Ww, Ww, Ww, Ww, Ww, Ss, Gs^Ft, Re^Efm, Re, Ss, Ss, Ss, Wo^Bw\, Wo, Ww
Ss, Ww, Ww, Gs^Ft, Ww, Ww, Ww^Bw|, Ds, Ww, Ds, Ww, Ww, Ss, Ss, Ss, Ss, Re^Efm, Rb, Rb, Rb^Efm, Gs^Ft, Gs^Ft, Ss, Gs^Ft, Ss, Ww, Wo, Ww
Gs^Ft, Ww^Ewf, Gs^Ft, Ww, Gs^Ve, Ds, Rb^Efm, Ww, Gs^Ve, Ww, Re^Efm, Rb^Efm, Re^Efm, Rb, Rb^Efm, Re^Efm, Gs, Gs^Ftp, Gs^Ft, Gs, Gs^Fet, Hh^Ft, Gs^Ft, Mm, Hh^Ft, Hh, Ss, Ww
Re, Re^Efm, Re^Efm, Re, Re^Efm, Re^Efm, Gs^Ft, Re^Efm, Rb^Efm, Rb^Efm, Gs, Gs^Ft, Gs^Fet, Gs^Efm, Gs^Ft, Gs^Ft, Gs^Efm, Hh^Ft, Gs^Ft, Hh, Hh, Hh^Ft, Hh^Ft, Mm, Mm, Mm, Mm, Mm
Gs^Ft, Gs^Ft, Gs^Ft, Gs^Ft, Gs^Fet, Gs^Ft, Gs^Ft, Gs^Ft, Gs, Gs^Ft, Gs^Fet, Gs^Ft, Gs^Ft, Hh^Ft, Gs^Ft, Hh, Hh, Hh, Hh, Mm, Hh, Hh, Hh, Mm, Mm, Mm, Mm, Mm
