Xv, Xv, Xv, Xv, Xv
Xv, Xv, Xv, Xv, Xv
Xv, Xv, 1 Xv, Xv, Xv
Xv, Xv, Xv, Xv, Xv
Xv, Xv, Xv, Xv, Xv
Xv, Xv, Xv, Xv, Xv
Xv, Xv, Xv, Xv, Xv
Xv, Xv, Xv, Xv, Xv
