Uue, Xue, Xue, Xue, Xue, Xue, Xue, Xue, Xue, Xue, Xue, Xue, Xue, Xue, Xue, Xue, Xue, Xue, Xue, Xue, Xue, Xue, Xue, Xue, Xue, Xue, Xue, Xue, Xue, Xue, Re, Xue, Xue, Xue, Xue, Xue, Xue, Xue, Xue, Xue, Xue, Xue
Xue, Uue, Uue, Xue, Xue, Xue, Xue, Xue, Xue, Xue, Xue, Xue, Xue, Xue, Xue, Xue, Xue, Xue, Xue, Xue, Xue, Xue, Xue, Xue, Xue, Xue, Uue, Uue, Uue, Uu^Ufi, Uue, Xue, Qxe, Xue, Xue, Xue, Xue, Xue, Xue, Xue, Xue, Xue
Xue, Xue, Xue, Uue, Uue, Xue, Xue, Xue, Xue, Xue, Xue, Xue, Xue, Xue, Xue, Xue, Xue, Xue, Xue, Xue, Xue, Xue, Xue, Xue, Xue, Xue, Xue, Ds, Ds, Ds, Uue, Qxe, Qxe, Xue, Xue, Xue, Xue, Xue, Xue, Xue, Xue, Xue
Xue, Xue, Xue, Xue, Uue^Ecf, Xue, Xue, Xue, Re, Qxe, Xue, Xue, Xue, Xue, Xue, Xue, Re, Xue, Xue, Xue, Xue, Xue, Xue, Xue, Xue, Xue, Ww, Ww, Ww, Ww, Ww^Bw|r, Qxe, Qxe, Qxe, Xue, Xue, Xue, Xue, Xue, Xue, Ds, Xue
Xue, Xue, Xue, Cer, 3 Ker, Cer, Cer, Xue, Re, Xue, Uue, Xue, Xue, Xue, Re, Re, Xue, Re, Re, Re, Xue, Xue, Xue, Xue, Ww, Ww, Wo, Wo, Wo, Uue, Uue, Ww, Ww, Ww, Wo, Ds, Xue, Xue, Ds, Ds, Ww, Xue
Xue, Xue, Xue, Cer, Re, Re, Re, Re, Uue, Uue, Uue, Uue, Re, Uue, Xue, Xue, Xue, Xue, Uu^Ufi, Re, Uue, Uue, Uue, Ds, Wo, Wo, Xue, Ds, Uue, Wo^Bw/r, Wo, Xue, Wo, Wo, Ww, Wo, Ww, Xue, Ww, Ww, Qxe, Qxe
Xue, Xue, Xue, Cer, Re, Uue, Xue, Uue, Uu^Uf, Re, Xue, Re, Uue, Re, Re, Xue, Xue, Xue, Xue, Xue, Xue, Uue, Ww^Bw\, Wwg, Wo, Wo, Xue, Xue, Uue, Xue, Xue, Wo, Xue, Ds, Ds, Wo, Ww, Ww, Qxe, Qxe, Qxua, Qxu
Xue, Xue, Xue, Uue^Vo, Re, Re, Re, Re, Uue^Vo, Xue, Xue, Xue, Uue, Uue, Re, Xue, Xue, Xue, Xue, Xue, Wwg, Wwg, Wo, Wo^Bw\, Re, Xue, Ke^Vov, Xue, Uue, Xue, Xue, Xue, Xue, Xue, Xue, Wo, Ww, Ww, Xue, Qxu, Qxu, Qxua
Xue, Xue, Qxe, Uu^Uf, Xue, Uue, Uue, Re^Ecf, Xue, Xue, Xue, Uue, Xue, Uue, Xue, Xue, Xue, Xue, Wwg, Wwg, Wo, Wo, Xue, Xue, Re, Re, Re, Uue, Uue, Uh, Uue, Qxe, Xue, Xue, Xue, Wo, Ww, Xue, Ds, Xue, Xue, Qxu
Xue, Xue, Re, Uue, Re, Uue, Xue, Xue, Xue, Xue, Uue, Uue, Re, Uue, Xue, Xue, Xue, Xue, Wwg, Wo, Xue, Xue, Xue, Xue, Re, Xue, Xue, Uue, Uue, Xue, Uue, Re, Ke^Vov, Xue, Xue, Wo, Wo, Wwg, Wwg, Ds, Xue, Xue
Xue, Xue, Re, Uue, Xue, Xue, Xue, Xue, Xue, Xue, Re, Re, Xue, Xue, Xue, Xue, Wwg, Wwg, Wo, Wo, Xue, Xue, Xue, Ke^Vov, Re, Re, Re, Uue, Re, Uue, Re, Re, Re, Xue, Xue, Xue, Xue, Wo, Wo, Ds, Ds, Xue
Ww, Ds, Ds, Uue^Vo, Xue, Xue, Xue, Xue, Re, Uue, Uue, Uue, Xue, Xue, Ds, Wwg, Wo, Ww, Uue, Xue, Xue, Xue, Xue, Re^Ecf, 4 Ket, Re, Re, Ce, Xue, Xue, Xue, Uue, Re, Uue, Uue, Xue, Xue, Uu^Ufi, Wwg, Wo, Wo, Xue
Wo, Ww, Ww, Ds, Xue, Xue, Uue, Re, Uue, Uue, Uh, Qxe, Xue, Ds, Wwg, Wwg, Ww, Xue, Uue^Em, Xue, Xue, Xue, Xue, Ce, Ce, Ce, Ce, Xue, Xue, Xue, Xue, Xue, Uue, Re, Uue, Xue, Xue, Xue, Wwg, Xue, Wo, Xue
Xue, Wo, Wwt, Xue, Xue, Xue, Ker^Vov, Re, Uue, Xue, Xue, Xue, Wwg, Wwg, Wo, Wo, Xue, Rb, Uue^Em, Uue, Uue^Uf, Xue, Xue, Xue, Xue, Ce, Xue, Xue, Xue, Xue, Uu^Ufi, Re, Uu^Ufi, Re, Xue, Xue, Gll^Ftr, Gll^Ftr, Wwg, Gll^Ftr, Wo, Gll^Ftr
Xue, Wo, Wwt, Xue, Xue, Uu^Ufi, Wwt, Wwg^Bw|r, Wwt, Xue, Wwg, Wwg, Wo, Wo, Xue, Xue, Xue, Uue^Em, Wwg, Ker^Vov, Uue^Uf, Xue, Xue, Xue, Xue, Xue, Xue, Xue, Xue, Xue, Xue, Ker^Vov, Re, Xue, Gll^Ftr, Xue, Gll^Ftr, Gll^Ftr, Wwg, Gll^Ftr, Wo, Gll^Ftr
Xue, Wo, Ww, Xue, Wwt, Wwt, Ds^Ii, Ds, Xue, Wwt, Ww, Wo, Wo, Xue, Uh, Xue, Uh, Uue, Uue, Uue^Uf, Xue, Xue, Xue, Xue, Xue, Xue, Gll^Ftr, Xue, Gll^Ftr, Gll^Ftr, Gll^Ftr, Uue, Rb, Gll^Ftr, Gll^Ftr, Gll^Ftr, Wo, Wo, Wo, Wo, Gll^Ftr, Gll^Ftr
Xue, Wo, Wo, Ww, Xue, Ds, Ds, Ds, Ds, Ds, Ww, Wo, Wwg, Uue, Xue, Uh, Xue, Xue, Uue, Xue, Xue, Xue, Xue, Xue, Gll^Ftr, Gll^Ftr, Gll^Ftr, Gll^Ftr, Gll^Ftr, Gll^Ftr, Gll^Ftr, Gll^Ftr, Rb, Gll^Ftr, Gll^Ftr, Wo, Ww, Ww, Gll^Ftr, Gll^Ftr, Mdd^Xm, Gll^Ftr
Xue, Wo, Wo, Ww, Ww, Xue, Ds^Ii, Ds, Ww, Ww, Wo, Wo, Xue, Xue, Xue, Xue, Xue, Xue, Ker^Vov, Uu^Ufi, Gll^Ftr, Xue, Xue, Xue, Gll^Ftr, Gll^Ftr, Gll^Ftr, Gll^Ftr, Gll^Ftr, Gll^Ftr, Hh^Ft, Gll^Ftr, Gll^Ftr, Rb, Gll^Ftr, Wo, Ww, Gll^Ftr, Gll^Ftr, Mdd^Xm, Mdd^Xm, Mv
Xue, Xue, Xue, Wo, Wo, Ww, Wo, Ww^Bw|r, Wo, Wo, Wo, Xue, Xue, Xue, Xue, Xue, Xue, Xue, Xue, Xue, Gll^Ftr, Gll^Ftr, Gll^Ftr, Gll^Ftr, Gll^Ftr, Gll^Ftr, Gll^Ftr, Gll^Ftr, Gll^Ftr, Hh^Ft, Hh^Vc, Gs, Rb, Rb, Wo, Wo, Ww, Gll^Ftr, Gll^Ftr, Gll^Ftr, Gll^Ftr, Mdd^Xm
Xue, Xue, Xue, Xue, Xue, Wo, Wo, Wo^Bw|r, Wo, Wo^Ii, Ds, Ds, Xue, Xue, Xue, Xue, Xue, Xue, Gll^Ftr, Gll^Ftr, Gs^Ft, Gs^Ft, Gs^Ft, Gll^Ftr, Gll^Ftr, Gll^Ftr, Gll^Ftr, Gll^Ftr, Ss, Hh^Ft, Wog, Dd^Ftd, Wo^Bw|r, Wo, Ww, Ww, Ss, Gll^Ftr, Gll^Ftr, Gll^Ftr, Gll^Ftr, Gll^Ftr
Xue, Xue, Xue, Xue, Xue, Xue, Xue, Re, Re, Ds, Xue, Xue, Xue, Xue, Xue, Xue, Gll^Ftr, Gll^Ftr, Gll^Ftr, Gll^Ftr, Gll^Ftr, Gll^Ftr, Gs^Ft, Gs^Ft, Gs^Ft, Gs^Ft, Ss, Ss, Wog, Wog, Ww, Wo, Ww^Bw|r, Ww, Hh^Ft, Hh^Ft, Ss, Hh^Ft, Hh^Ft, Gll^Ftr, Gll^Ftr, Gll^Ftr
Xue, Xue, Xue, Xue, Xue, Xue, Uh, Uue, Re, Uue, Xue, Xue, Xue, Xue, Gll^Ftr, Gll^Ftr, Gll^Ftr, Gll^Ftr, Gll^Ftr, Gll^Ftr, Gll^Ftr, Gs^Ft, Gs^Ft, Gs^Ft, Gll^Ftr, Gs^Ft, Ss, Ss, Wog, Ss, Ss, Ww, Gd, Ker^Vov, Hh^Ft, Hh^Ft, Ww, Hh^Ft, Hh^Ft, Hh^Ft, Hh^Ft, Hh^Ft
Xue, Xue, Xue, Xue, Xue, Xue, Uu^Ufi, Re, Uu^Ufi, Xue, Xue, Xue, Gll^Ftr, Gll^Ftr, Gll^Ftr, Gll^Ftr, Gll^Ftr, Gll^Ftr, Gll^Ftr, Gs^Ft, Gs^Ft, Gs^Ft, Gll^Ftr, Gs^Ftp, Ds, Ss, Wog, Wog, Chs, Ss, Sm, Ker^Vov, Gd, Hh^Ft, Hh^Ft, Ss, Ss, Hh^Ft, Hh^Ft, Hh^Ft, Hhd^Fts, Hhd^Fts
Xue, Xue, Xue, Xue, Xue, Xue, Xue, Ker^Vov, Gs, Gs, Gll^Ftr, Gll^Ftr, Gll^Ftr, Gll^Ftr, Gll^Ftr, Gll^Ftr, Gs^Ft, Gll^Ftr, Gll^Ftr, Gll^Ftr, Gll^Ftr, Gs^Ft, Dd^Ftd, Ds, Wo, Wog, Ss, Chw, 2 Khs, Chs, Gd, Gd, Gll^Ftr, Hh^Ft, Hh^Ft, Ss, Ss, Hh^Ft, Hh^Ft, Hhd^Fts, Hhd^Fts, Hhd^Fts
Xue, Xue, Xue, Xue, Xue, Xue, Xue, Gll^Ftr, Gll^Ftr, Gs, Gs, Gll^Ftr, Gll^Ftr, Gll^Ftr, Gll^Ftr, Gll^Ftr, Gll^Ftr, Gs^Ft, Gs^Ft, Gll^Ftr, Gll^Ftr, Gs^Ft, Wo, Wo, Ww, Hh^Ft, Gd, Chs, Chr, Chr, Gd, Gs^Ftp, Gll^Ftr, Hh^Ft, Hh^Ft, Ss, Ss, Ss, Hh^Ft, Hhd^Fts, Hhd^Fts, Hhd^Fts
Xue, Xue, Xue, Xue, Xue, Xue, Gll^Ftr, Gll^Ftr, Gll^Ftr, Gll^Ftr, Gs^Ft, Gs, Gs, Gll^Ftr, Gs^Ft, Gll^Ftr, Gs^Ft, Gs^Ft, Gs^Ft, Gll^Ftr, Gs^Ft, Gs^Ft, Wo, Ww, Ker^Vov, Gd, Hh^Ft, Sm, Gll^Ftr, Gll^Ftr, Hh^Ft, Gd, Gs^Ftp, Hh^Ft, Hh^Ft, Ss, Ss, Ss, Hh^Ft, Hhd^Fts, Hhd^Fts, Hhd^Fts
Xue, Xue, Xue, Xue, Xue, Gll^Ftr, Hh^Ft, Gll^Ftr, Gll^Ftr, Gll^Ftr, Gll^Ftr, Gs^Ft, Gs, Gs^Ft, Gs^Ft, Gs^Ft, Gll^Ftr, Gll^Ftr, Gs^Ft, Gs^Ft, Hh^Ft, Ww, Wo, Ds, Gd, Gd, Hh^Ft, Sm, Hh^Ft, Hh^Ft, Hh^Ft, Re, Gd, Ker^Vov, Ss, Ww^Ewl, Ss, Ss, Hh^Ft, Hhd^Fts, Hhd^Fts, Hhd^Fts
Xue, Xue, Xue, Xue, Xue, Gll^Ftr, Hh^Ft, Hh^Ft, Gll^Ftr, Gs^Ft, Gll^Ftr, Gll^Ftr, Gs^Ft, Gs, Gs^Ft, Gs^Ft, Gs^Ft, Gs^Ft, Hh^Ft, Hh^Ft, Hh^Ft, Ww, Wo^Bw/r, Ww^Bw/r, Wwg, Ker^Vov, Ss, Ss, Ww^Ewf, Hh^Ft, Ss, Ker^Vov, Ww^Bw|r, Ww, Ss, Ss, Hh^Ft, Hh^Ft, Mdd^Xm, Hhd^Fts, Hhd^Fts, Hhd^Fts
Xue, Xue, Xue, Xue, Xue, Gll^Ftr, Xue, Gll^Ftr, Gll^Ftr, Gll^Ftr, Gs^Ft, Gs^Ft, Gs^Ft, Gs, Gs^Ft, Gs^Ft, Gs^Ft, Hh^Ft, Hh^Ft, Hh^Ft, Gd, Gd, Hh^Ft, Wo, Ss, Wwg, Ss, Ss, Ss, Ww, Sm, Ss, Gd, Hh^Ft, Hh^Ft, Hh^Ft, Hh^Ft, Mdd^Xm, Mdd^Xm, Mv, Mdd^Xm, Hhd^Fts
Xue, Xue, Xue, Xue, Xue, Xue, Xue, Xue, Gll^Ftr, Gll^Ftr, Gll^Ftr, Gs^Ft, Gs^Ft, Gs, Gs^Ft, Gs^Ft, Gs^Ft, Gs^Ft, Gd, Gd, Hh^Ft, Hh^Ft, Wo, Wo, Wwg, Wwg, Hh^Ft, Ss, Gs^Ft, Ss, Hh^Ft, Sm, Gd, Hhd^Fts, Hhd^Fts, Hh^Ft, Hh^Ft, Mdd^Xm, Mdd^Xm, Mdd^Xm, Mdd^Xm, Hh
Xue, Xue, Xue, Xue, Xue, Xue, Xue, Gll^Ftr, Hh^Ft, Gll^Ftr, Gll^Ftr, Gll^Ftr, Gll^Ftr, Gd, Gd, Gs^Ft, Gs^Ft, Gs^Ft, Gd, Hh^Ft, Ss, Ss, Ww, Ww, Hh^Ft, Hh^Ft, Hh^Ft, Gs^Ft, Hh^Ft, Hh^Ft, Hhd^Fts, Hhd^Fts, Hhd^Fts, Gd, Gd, Hhd^Fts, Hhd^Fts, Hh^Ft, Dd^Ftd, Hhd^Fts, Hhd^Fts, Mdd^Xm
Xue, Xue, Xue, Xue, Gll^Ftr, Xue, Gll^Ftr, Gll^Ftr, Gll^Ftr, Gll^Ftr, Hhd^Fts, Gll^Ftr, Hhd^Fts, Hhd^Fts, Gd, Gs^Ft, Gd, Gd, Ss, Hh^Ft, Ss, Ww, Wo, Ww, Hh^Ft, Hh^Ft, Mdd^Xm, Mdd^Xm, Mv, Mdd^Xm, Hhd^Fts, Gd^Fts, Hhd^Fts, Hhd^Fts, Gd, Hhd^Fts, Hhd^Fts, Gd^Efm, Hhd^Vc, Dd^Ftd, Hhd^Fts, Hhd^Fts
Xue, Xue, Gll^Ftr, Gll^Ftr, Hh^Ft, Gll^Ftr, Gll^Ftr, Gll^Ftr, Gll^Ftr, Gll^Ftr, Gll^Ftr, Hhd^Fts, Hhd^Fts, Hhd^Fts, Hh^Ft, Gd, Hh^Ft, Ss, Ss, Ss, Ss, Wo, Wo, Ww, Hhd^Fts, Hh^Ft, Hh^Ft, Mdd^Xm, Mdd^Xm, Hhd^Fts, Hhd^Fts, Hhd^Fts, Hhd^Fts, Hhd^Fts, Gd, Hhd^Fts, Ss, Ss, Ss^Bw|r, Ss, Ss, Ss
Gll^Ftr, Ww, Gll^Ftr, Hh^Ft, Gll^Ftr, Gll^Ftr, Gll^Ftr, Gll^Ftr, Gll^Ftr, Gll^Ftr, Gll^Ftr, Hh^Ft, Hh^Ft, Hh^Ft, Hhd, Gd, Sm, Sm, Ss, Ss^Vhs, Ss^Bw\r, Wo, Wo, Ww, Hh^Ftp, Hhd^Fts, Hh^Ftp, Hhd^Fts, Hhd^Fts, Gd^Fts, Hhd^Fts, Hhd^Fts, Rd, Gd, Ss, Ss, Ss, Ss, Ww, Ss, Ss, Ss
Gll^Ftr, Ww, Gll^Ftr, Hh^Ft, Hh^Ft, Hh^Ft, Mdd^Xm, Gll^Ftr, Gll^Ftr, Gll^Ftr, Gll^Ftr, Hh^Ft, Hh^Ft, Hhd, Gd, Gd, Ss, Ss, Ss, Ss, Ss, Wo, Wo, Ww, Ww, Hh^Ftp, Hh^Ftp, Hhd^Fts, Hhd^Fts, Hhd^Fts, Hhd^Fts, Hhd^Fts, Rd, Ds, Ww, Ww, Ww, Ww, Ww, Hd^Ftd, Hd^Ftd, Ss
Gll^Ftr, Ww, Gll^Ftr, Gll^Ftr, Mdd^Xm, Mdd^Xm, Mv, Mdd^Xm, Gll^Ftr, Gll^Ftr, Gll^Ftr, Hh^Ft, Hhd, Hhd, Ww, Ww^Bw\r, Ww^Bw\r, Ww, Ss, Ss, Ss, Ss, Ss, Wo, Wo, Ww, Ww, Hhd^Fts, Ds, Ds, Ds, Rd, Hhd^Fts, Ww, Ss, Ss, Hd^Ftd, Ww^Ewl, Hd^Ftd, Hd^Ftd, Ds, Ss
Gll^Ftr, Ww, Gll^Ftr, Gll^Ftr, Gll^Ftr, Mdd^Xm, Mdd^Xm, Mdd^Xm, Gll^Ftr, Gll^Ftr, Hh^Ft, Hh^Ft, Ww, Hhd, Ww, Dd^Ftd, Hh^Ft, Gd, Gd, Ss, Ss, Ss, Ss, Ww^Ewf, Ds, Wo, Wo, Ww, Ww, Ww, Ww, Hhd^Bw|r, Ww, Ww, Ww^Ewl, Ss, Ss, Hd^Ftd, Ds, Dd, Dd^Ftd, Ss
Gll^Ftr, Ww, Ww, Gll^Ftr, Gll^Ftr, Gll^Ftr, Gll^Ftr, Gll^Ftr, Gll^Ftr, Gll^Ftr, Ww, Ww, Hh^Ft, Ww, Hh^Ft, Hh^Ft, Hh^Ft, Hh^Ft, Uue^Fts, Rd, Ds, Ww^Ewl, Ds, 1 Ke, Ce, Hhd^Fts, Ds, Wo, Wo, Wo, Wo, Ww^Bw|r, Wo, Ww, Ww, Ww, Wo, Ss, Ss, Ds, Ss, Ss
Gll^Ftr, Gll^Ftr, Gll^Ftr, Ww, Ww, Gll^Ftr, Ww, Gll^Ftr, Ww, Ww, Gll^Ftr, Hh^Ft, Hh^Ft, Hh^Ft, Hh^Ft, Hh^Ft, Uue^Fts, Uue^Fts, Uue^Fts, Rd, Rd, Dd^Ftd, Ke^Vov, Ce, Ce, Hhd, Dd, Ds, Hhd^Fts, Hhd^Fts, Hhd, Wo^Bw|r, Ds, Ww, Ww, Wo, Wo, Wo, Wo, Ww, Ww, Ww
Gll^Ftr, Gll^Ftr, Gll^Ftr, Gll^Ftr, Gll^Ftr, Ww, Gll^Ftr, Ww, Gll^Ftr, Gll^Ftr, Gll^Ftr, Gll^Ftr, Uue^Fts, Hh^Ft, Uue^Fts, Uue^Fts, Uue^Fts, Uue^Fts, Dd^Ftd, Dd, Dd, Rd, Rd, Ce, Dd, Dd, Dd, Dd, Hd^Ftd, Dd^Ftd, Rd, Rd, Ss, Ww, Ww, Wo, Wo, Wo, Wo, Wo, Ww, Ww
Gll^Ftr, Gll^Ftr, Gll^Ftr, Gll^Ftr, Gll^Ftr, Gll^Ftr, Gll^Ftr, Gll^Ftr, Gll^Ftr, Gll^Ftr, Uue^Fts, Uue^Fts, Uue^Fts, Uue^Fts, Uue^Fts, Uue^Fts, Dd, Dd, Dd^Ftd, Dd, Dd, Dd, Dd, Rd, Hd^Ftd, Ds, Ds, Dd, Rd, Rd, Dd, Dd, Ss, Ss, Ww, Wo, Wo, Wo, Ww, Ww, Ww^Ewf, Ww^Ewl
Gll^Ftr, Gll^Ftr, Gll^Ftr, Gll^Ftr, Gll^Ftr, Gll^Ftr, Gll^Ftr, Gll^Ftr, Uue^Fts, Uue^Fts, Uue^Fts, Uue^Fts, Uue^Fts, Uue^Fts, Dd^Ftd, Dd^Ftd, Dd, Dd, Dd, Dd, Dd, Dd, Dd, Rd, Rd, Dd, Rd, Rd, Dd, Dd, Dd, Dd^Ftd, Ss, Ss, Ss, Ww, Ww, Ww, Ww, Ww, Ww, Ww^Ewl
