Gg, Gg, Gg, Gg, Gg, Gg, Gg, Gg, Gg, Gg, Gg, Gg, Gg, Gs^Fds, Gg, Gs^Fds, Gs^Fds, Gs^Fds, Gs^Fds, Gg, Gg, Gg, Ds, Ds, Ww, Wot, Wot, Wot, Wot, Wot, Wot, Gg
Gg, Gg, Gg, Gg, Gg, Gg, Gg, Gg, Gg, Gs^Fds, Gs^Fds, Gs^Fms, Gs^Fds, Gs^Fds, Gs^Fds, Gg, Gs^Fds, Gg, Gs^Fds, Gs^Fds, Gg, Dd^Vdt, Ds, Ds, Ds, Ww, Wot, Wot, Wot, Wot, Wot, Wot
Gg, Gg, Gg, Gg, Gg, Gg, Gg, Gg, Gg, Gs^Fds, Gg, Gg, Gs^Fms, Gs^Fds, Gs^Fms, Gs^Fms, Gs^Fms, Gs^Fds, Gs^Fds, Gs^Fds, Gs^Fds, Ce, Ke, Dd^Vdt, Ds, Ww, Ww, Wot, Wot, Wot, Wot, Wot
Gg, Gg, Gg, Gg, Gs^Fds, Gs^Fds, Gs^Fds, Gg, Gg, Gs^Fds, Gs^Fds, Gs^Fds, Gs^Fds, Gs^Fms, Gs^Fms, Gg, Gs^Fds, Gs^Fms, Gs^Fds, Gs^Fds, Gg, Ce, Ce, Ds, Ds, Ds, Ds, Ww, Wot, Wot, Wot, Wot
Gg, Gg, Gg, Gg, Gs^Fds, Gs^Vh, Gg, Gg, Gg, Gg, Gg, Gs^Fds, Gs^Fms, Gs^Fds, Gg, Gs^Fms, Gs^Fms, Gs^Fms, Gg, Gs^Fds, Gg, Gg, Gg, Dd^Vdt, Ds, Ds, Ds, Ww, Ww, Wot, Wot, Wot
Gg, Gg, Gg, Gg, Gs^Fds, Gs^Fds, Gg^Emf, Gg, Gg, Gg, Gg, Gs^Fds, Gs^Fds, Gg, Gs^Fds, Gs^Fms, Gs^Fms, Gs^Fms, Gs^Fds, Gs^Fds, Gg, Gg, Gg, Gg, Gg, Ds, Ds, Ww, Ww, Wot, Wot, Wot
Gg, Gg, Gg, Gg, Gg, Gg^Emf, Gg, Gg^Emf, Gg, Gg, Gg, Gg, Gg, Gs^Fds, Gg, Gs^Fds, Gs^Fds, Gs^Fds, Gs^Fds, Gg, Rb^Gvs, Gg, Gg, Gg, Gg, Ds, Ds, Ww, Ww, Wot, Wot, Wot
Gg, Gg, Gg, Gg, Gg, Gg, Hh, Gg, Gg, Gg, Gg, Gg, Gg, Gg, Gg, Gg, Gg, Gg, Rb^Gvs, Rb^Gvs, Rb^Gvs, Gs^Vh, Gg, Gg, Gg, Ds, Ds, Ww, Wot, Wot, Wot, Wot
Gg, Gg, Gg, Gg, Hh, Hh, Hh, Hh, Hh, Gg, Gg, Gg, Gg, Gg, Gg, Gg, Gg, Gg, Gg, Rb^Gvs, Rr, Rr, Gg, Gg, Ds, Ds, Ww, Ww, Wot, Wot, Wot, Wot
Gg, Gg, Hh, Hh, Hh, Hh, Gs^Fms, Hh, Gs^Fms, Gg, Gg, Gg, Gg, Gg, Gg, Gg, Gg, Gg, Rr, Rr, Gg, Gg, Gg, Gg, Ds, Ds, Ww, Wwr, Wwr, Wot, Wot, Wot
Gg, Hh, Hh, Hh, Gs^Fms, Gs^Fms, Gg, Gs^Fms, Rb^Gvs, Gg, Rb^Gvs, Gg, Gg, Gg, Gg, Gg, Gg, Gg, Rr, Gg, Wwg, Wwg, Wwg, Wwg, Wwg, Ww, Ww, Wwr, Wot, Wot, Wot, Wot
Gg, Hh, Gg, Gg, Gg, Gg, Gg, Gg, Rb^Gvs, Rb^Gvs, Rb^Gvs, Rb^Gvs, Rb^Gvs, Gg, Gg, Gg, Ss, Wwg, Wwg, Wwg^Bw\r, Rp, Wwg, Ds, Ds, Ww, Ww, Wot, Wot, Wot, Wot, Wot, Wot
Gg, Gg, Gs^Fds, Gg, Gg, Gg, Gg, Gs^Vh, Gg, Rb^Gvs, Rb^Gvs, Rb^Gvs, Gg, Rb^Gvs, Ss, Ss, Wwg, Wwg, Gs^Fms, Gg, Gg, Rp, Rp, Ds, Ww, Ww, Wot, Wot, Wwrt, Wot, Wot, Wot
Gg, Gg, Gs^Fds, Gg, Gs^Fds, Gs^Fds, Gs^Fds, Rr, Rr, Gg, Gg, Rb^Gvs, Gg, Gg, Ss, Wwg, Gg, Gs^Fms, Gs^Fms, Gg, Gs^Vh, Gg, Rp, Ds, Ds, Ww, Ww, Wot, Wot, Wot, Wot, Wot
Gg, Gg, Gs^Fds, Gs^Fds, Gs^Fms, Gs^Fms, Gs^Fds, Gs^Fds, Rr, Gg, Gg, Gg, Gg, Ss, Wwg, Wwg, Gs^Fms, Gs^Fms, Gs^Fms, Gg, Gg, Gg, Rp, Ds, Gg, Ww, Ww, Ww, Wwr, Wwr, Wot, Wot
Gg, Gg, Gg, Gs^Fds, Gs^Fds, Gs^Fds, Gg, Gs^Fds, Rr, Gg, Gg, Gg, Gg, Ss, Wwg, Gg, Gg, Gs^Fms, Gg, Gg^Eff, Gg^Eff, Gg^Eff, Rp, Gg, Wwg, Ds, Ww, Ww, Wwr, Wot, Wot, Wot
Gg, Gg, Gg, Gg, Gg, Gg, Gg, Gg, Rr, Gg, Gg, Gg, Gg, Ss, Wwg, Gg, Wwg, Wwg, Wwg, Wwg, Wwg, Wwg, Wwg^Bw|, Wwg, Wwg, Wwg, Ww, Ww, Ww, Wot, Wot, Wot
Gs^Fds, Gs^Fds, Gs^Fds, Gg, Rr, Rr, Rr, Rr, Gg, Rr, Rr, Gg, Wwg, Wwg, Gg, Wwg, Gg^Eff, Gs^Vl, Gg, Gg, Gg, Ce, Rp, Ce, Gg, Ds, Ds, Ww, Ww, Wot, Wot, Wot
Gs^Fms, Gs^Fms, Gs^Fds, Gs^Vl, Rb^Gvs, Rb^Gvs, Rb^Gvs, Gg, Gg, Gg, Wwg, Wwg^Bw\r, Rp, Ce, Gg, Gg^Emf, Gg^Emf, Gg^Eff, Gg, Gg, Gg, Gg, Rp, Gg, Gg, Ds, Ds, Ww, Wot, Wot, Wot, Wot
Gg, Gs^Fds, Rb^Gvs, Rb^Gvs, Rb^Gvs, Rb^Gvs, Gg, Gg, Wwg, Wwg, Gg, Ce, Rp, Gs^Vh, Gg, Gs^Vl, Gg^Eff, Gg^Eff, Gg, Gg, Gg, Rr^Vhc, Rp, Gg, Ce, Ds, Ds, Ww, Wot, Wot, Wot, Wot
Gg, Gg, Gg, Rb^Gvs, Gg, Gg, Wwg, Wwg, Gg, Gg, Gg^Gvs, Gg, Rp, Gg, Gg, Gg, Gg, Gg, Gg, Rr^Vhc, Rp, Rp, Gg, Gg, Ds, Ds, Ds, Ww, Wot, Wot, Wot, Wot
Gg, Gg, Gg, Gg, Gg, Gg, Wwg, Wwg, Gg, Gg^Gvs, Gg^Gvs, Gs^Fms, Rp, Gs^Eff, Gg^Eff, Gg^Fet, Gg, Rr^Vhc, Rp, Rp, Gs, Gg, Gg, Gg^Bw\, Ds^Bw\, Ds, Wot, Wot, Wot, Wot, Wot, Wot
Wwg, Gg, Wwg, Gg, Wwg, Wwg, Gg, Gg, Gg, Gs^Vh, Rp, Rp, Gs^Vh, Rp, Rp, Gg^Wm, Rp, Rp, Gg, Gg, Gg, Gs^Vh, Ce, Ds, Ds, Wot^Bw\, Wot^Bw\, Wot, Wot, Wot, Wot, Wot
Wwg, Wwg, Wwg, Wwg, Wwg, Wwg, Wwg, Ce, Rp, Rp, Gg, Gg, Gg, Gg, Rp^Dr, Rp, Gs^Vh, Gg^Eff, Gg^Eff, Gg, Gg, Gg, Ds, Ds, Ww, Ww, Wot, Wot, Wot, Wot, Wot, Wot
Gg, Wwg, Gg, Wwg, Gg, Wwg, Wwg^Bw/, Wwg^Bw/, Wwg, Ce, Gg^Edb, Gg, Gg^Es, Gg, Gg, Rp, Gg, Gg^Edt, Gg, Gg, Ce, Ds^Bw\, Ds^Bw\, Ww, Wot, Wot, Wot, Wot, Wot, Wot, Wot, Wot
Gg, Gg, Gg, Gg, Gg, Gg, Gg, Wwg, Wwg, Wwg, Wwg, Wwg, Wwg, Gg, Ce, Rp, Ce, Gg, Gg, Gg, Ds, Ds, Ww, Wot^Bw\, Wot^Bw\, Wot, Wot, Wot, Wot, Wot, Wot, Wot
Gg, Gg, Gg, Gg, Gg, Gg, Gg, Gg, Gg, Wwg, Ss^Vhs, Wwg, Wwg, Wwg, Wwg, Rp, Wwg, Gg, Wwg, Gg, Wwg, Ww, Ww, Wot, Wot, Wot, Wot, Wot, Wot, Wot, Wot, Wot
Gg, Gs^Fds, Gs^Fds, Gg, Gg, Gg, Gg, Gg, Gg, Gg, Gg, Gg, Gg, Wwg, Wwg, Wwg^Bw|, Wwg, Wwg, Wwg, Wwg, Wwg, Wwg, Ww, Wot, Wot, Wot, Wot, Wot, Wot, Wot, Wot, Wot
Gg, Gg, Gg, Gs^Fds, Gs^Fds, Gg, Gg, Gg, Gg, Gg, Gg, Gg, Gg, Gg, Gg, Wwg^Bw|, Gg, Gg, Gg, Wwg, Hd, Ds, Ds, Ww, Ww, Wot, Wot, Wot, Wot, Wot, Wot, Wot
Gg, Gg, Gs^Fds, Hh, Hh, Gs^Fds, Hh, Gg, Gs^Fms, Gg, Gg, Gg, Gg, Gg, Gg, Gg, Gg, Gg, Gg, Gg, Gg, Hd, Dd^Vda, Ds, Ww, Ww, Ww, Wot, Wot, Wot, Wot, Wot
Gg, Gll^Fp, Gll^Fp, Gs^Fds, Hh, Hh, Gs^Fds, Gg, Gs^Fds, Gs^Fms, Gg, Gg, Gg, Gg, Gg, Gg, Gg, Gg, Gg, Gg, Gg, Hd, Hd, Ds, Hd, Ww, Ww, Ww, Ww, Wot, Wot, Wot
Gg, Gll^Fp, Gg, Gll^Fp, Gg, Hh, Gg, Gg, Gg, Gg, Gg, Gg, Gg, Gg, Gg, Gg, Gg, Gg, Gg, Gg, Gg, Gg, Gg, Hd, Hd, Ds, Ds, Ww, Ww, Ww, Wot, Wot
