Wwt, Wot, Wwt, Wwt, Wwt, Wwt, Wwt, Ds, Ds, Gg, Gg, Gg, Ss, Ss, Gg, Gg, Ss, Gg, Gg, Gg, Gg^Ft, Gg, Gg, Gg, Gg^Ft, Gg, Gg, Gg, Gg, Gg, Gg, Gg, Gg, Gg, Gg, Gg, Gg, Gg, Gg, Gg, Gg, Gg
Wot, Wot, Wwt, Wwt, Wwt, Wwt, Wwt, Wwt, Wwt, Ds, Gg, Gg, Ss, Gg, Gg, Gg, Gg, Ss, Ss, Ss, Gg^Ft, Gg, Gg^Ft, Gg^Ft, Gg^Ft, Gg, Gg, Gg, Gg^Ft, Gg, Gg, Gg, Gg, Gg, Gg, Ss, Gg, Gg, Gg, Gg, Gg, Gg
Wot, Wot, Wot, Wwt, Wwt, Wwt, Wwt, Wwt, Wwt, Ds, Ds, Ss, Ss, Gg, Gg, Gg^Ftr, Gg, Gg, Gg, Ss, Gg, Gg^Ft, Gg^Ft, Gg^Ft, Gg^Vdr, Gg, Gg, Gg, Gg^Ft, Gg, Gg, Gg, Gg, Gg, Chs, Ss, Ss^Vm, Gg, Gg, Gg, Gg^Ft, Gg
Wot, Wot, Wot, Wot, Wwt, Wwt, Wwt, Wwt, Wwt, Wwt, Wwt, Ds, Gg, Gg, Gg, Gg^Ftr, Gg, Gg, Gg, Gg, Gg, Gg, Gg, Gg, Gg, Gg, Gg^Ft, Gg^Ft, Gg^Ft, Gg, Gg, Gg, Gg^Ftr, Ss, Chs, Gg, Gg, Gg, Gg, Gg^Ft, Gg^Ft, Gg
Wot, Wot, Wot, Wot, Wwt, Wwt, Wwt, Wwt, Wwt, Wwt, Chw, Chs, Khs, Chs, Wwg, Gg, Ss, Gg, Gg^Ft, Gg^Ft, Gg^Ft, Gg, Gg, Gg, Gg, Gg, Gg, Gg^Ft, Gg, Gg, Gg^Ft, Gg, Gg, Ss, Chs, Khs, Chs, Gg, Gg, Gg^Ft, Gg^Ft, Gg
Wot, Wot, Wot, Wot, Wwt, Wwt, Wwrt, Wwrt, Wwt, Chw, Wwt, Chs, Gg, Gg, Gg, Wwg, Wwg, Gg^Ft, Ss, Gg, Gg^Ft, Gg, Ss, Wwg, Gg, Gg, Gg, Gg, Gg, Gg^Ft, Gg, Gg, Gg, Gg, Sm, Chs, Sm, Gg, Gg^Ft, Gg^Ft, Gg^Ft, Gg
Wot, Wot, Wwt, Wwt, Wwt, Wwt, Wwrt, Wwt, Ww^Vm, Wwt, Wwt, Ds, Ds^Esd, Gg, Gg, Gg, Wwg, Gg^Ft, Wwg, Gg^Vc, Gg, Gg^Ft, Gg, Ss, Ss, Ss, Wwg, Ss, Gg, Gg^Ft, Gg^Ft, Gg, Gg, Gg^Ft, Wwg, Sm, Wwg, Gg, Gg^Ft, Gg^Ft, Gg, Gg
Wot, Wot, Wot, Wwt, Wwt, Wwt, Wwt, Wwt, Wwt, Wwt, Wwt, Ds, Ds^Ftp, Gg, Gg^Ft, Gg, Wwg, Gg, Wwg, Gg, Gg^Ft, Gg, Gg, Gg, Gg, Gg, Wwg, Gg, Gg, Gg^Ftp, Gg, Gg^Ft, Gg^Ft, Gg^Ft, Gg, Wwg, Wwg, Wwg^Vhs, Gg, Gg, Gg, Gg
Wot, Wot, Wot, Wot, Wwt, Wwt, Wwt, Wwt, Wwt, Wwt, Wwt^Ftp, Ds, Gg^Esd, Gg, Gg^Ft, Gg, Gg, Wwg, Gg, Gg^Ft, Gg, Gg^Ft, Gg, Gg, Ss, Gg, Chs, Wwg, Gg, Gg^Ftp, Gg, Gg, Gg^Ft, Gg^Ft, Gg, Ss, Gg, Gg, Gg, Gg, Gg, Gg
Wot, Wot, Wot, Wot, Wot, Wwt, Wwrt, Wwt, Wwt, Wwt, Ds, Ss, Ss, Gg, Gg, Gg^Ft, Gg^Ft, Gg^Ft, Gg, Wwg, Gg^Ftp, Gg, Wwg, Wwg, Gg, Chs, Gg, Ss^Vhs, Gg, Gg, Gg, Gg, Hh^Ft, Hh, Hh^Ft, Hh, Gg, Gg, Gg, Gg, Gg^Ftr, Gg
Wot, Wot, Wot, Wot, Wot, Wwt, Wwt, Wwt, Wwt, Ds, Dd^Vda, Gg, Ss, Gg, Gg, Gg, Gg, Gg, Gg, Gg, Gg, Wwg, Gg, Chs, Chs, Khs, Chs, Wwg, Wwg, Gg, Gg, Gg, Gg, Gg^Ft, Gg^Ft, Gg, Gg, Gg, Gg^Ftr, Gg^Ftr, Gg^Ftr, Gg
Wot, Wot, Wot, Wot, Wwt, Wwt, Wwt, Wwt, Wwt, Ds, Gg, Gg, Gg, Wwg, Wwg, Wwg, Wwg, Wwg, Wwg, Gg, Wwg, Wwg, Gg, Gg, Gg, Gg, Gg, Gg^Ft, Wwg, Gg, Ss, Gg, Gg, Gg, Gg, Gg, Gg^Ftr, Gg^Ftr, Gg, Gg, Gg, Gg
Wot, Wot, Wot, Wot, Wwt, Wwt, Wwrt, Wwt, Ds, Ds, Gg^Ftr, Gg^Ftr, Gg, Gg, Gg, Gg, Gg, Gg, Ss, Wwg, Gg, Gg, Gs^Ft, Gs^Ft, Gg, Ss, Ss, Gg, Gg, Ss, Gg, Gg, Gs^Ft, Gg, Gg, Gg, Gg^Ftr, Gg, Wwg, Wwg, Wwg, Gg
Wot, Wot, Wot, Wot, Wwt, Wwt, Wwt, Wwt, Wwg, Gg^Ftr, Gg^Ftr, Gg, Gg, Gg, Gg, Gg^Ftp, Gg, Gg, Gg, Ss, Gg, Gg, Gg^Ft, Gs^Ft, Wwg, Wwg, Ss, Gg^Ft, Gg^Ft, Gg^Ft, Gg^Ft, Gg^Ft, Ss, Gg, Gg^Ftr, Gg^Ftr, Gg, Gg^Vht, Wwg, Wwg^Ewf, Gg, Gg
Wot, Wot, Wwt, Wwt, Wwt, Wwt, Wwt, Wwt, Ds, Wwg, Wwg, Gg^Ftr, Gg, Gg, Gg^Ft, Gg^Vht, Gg, Gg, Gg, Ss, Gg, Gg, Wwg, Wwg, Gg, Gg, Gg^Ftr, Ss, Ss, Gg, Gg, Gg, Ss, Gg, Gg^Ftr, Gg^Ftr, Ss^Ftr, Ss, Gg, Gg, Gg, Gg
Wot, Wot, Wwt, Wwt, Wwt, Ss, Ss, Ss, Ds, Ds, Wwg, Gg, Gg, Gg, Gg, Gg^Ft, Gg^Ft, Gg, Gg, Gg, Hh, Hh, Wwg, Gg, Gg, Gg^Ftr, Gg, Gg, Gg, Gg, Gg, Gg, Gg, Ss, Gg^Ftr, Ss^Ftr, Gg^Ftr, Gg^Ftr, Gg^Ftr, Gg^Ftr, Gg, Gg
Wot, Wot, Wwt, Wwt, Wwt, Ss, Ds, Ds, Ds, Ds^Ftd, Ds, Ss, Wwg, Gg, Ss, Gg, Gg^Ft, Gs^Ft, Gg, Gg^Ft, Hh^Ft, Wwg, Gg, Gg, Gg, Gg, Gg^Ft, Gg, Gg, Gg, Gg, Gg, Gg, Gg, Gg^Vc, Gg^Ftr, Gg, Gg^Ftr, Gg^Ftr, Gg^Ftr, Gg, Gg
Wot, Wot, Wwt, Wwt, Wwt, Ds, Ds, Gg, Gg, Ds, Gg^Ftr, Gg, Gg, Ss, Gg, Wwg, Wwg, Wwg, Gg, Gg, Ww^Ewl, Ww^Ewl, Gg^Vc, Gg, Gg^Ft, Gg^Ft, Gg, Gg^Ft, Gg^Ft, Gg^Ft, Gg^Ftr, Gg, Gg, Gg, Gg, Gg, Gg, Gg^Ftr, Gg^Ftr, Gg^Ftr, Gg^Ftr, Gg
Wot, Wot, Wwt, Wwt, Ds, Ds, Gg, Gg, Gg^Ftr, Gg^Ftr, Gg^Ftr, Gg, Gg, Gg, Gg, Gg, Gg, Wwg, Wwg, Ss, Gg, Gg, Gg, Gg, Gg^Ft, Gg, Gg^Ft, Gg, Gg^Ft, Gg, Gg, Gg, Gg, Gg, Ss, Sm, Ss, Gg, Gg, Gg, Gg, Gg
Wot, Wot, Wwt, Wwt, Ds, Gg, Gg, Gg^Ftr, Gg, Gg^Ftr, Gg, Gg, Wwg, Gg, Wwg, Ss, Wwg, Wwg, Gg, Ss, Wwg, Gg, Ss, Gg, Gg, Gg^Ft, Gg, Gg^Ftr, Gg^Ft, Gg^Ft, Gg^Ft, Gg, Ss, Ss, Sm, Ss, Gg, Gg, Gg, Gg, Gg, Gg
Wot, Wot, Wwt, Wwt, Ds, Gg, Wwg, Gg, Gg, Gg, Wwg^Bw\, Wwg, Ss, Wwg, Gg, Gg, Gg, Ss, Gg, Gg, Gg, Wwg, Gg^Ftr, Ss, Wwg, Gg, Gg, Gg, Gg^Ft, Wwg, Gg^Ft, Gg, Sm, Sm, Sm, Gg, Gg, Gg, Gg, Gg, Gg, Gg
Wot, Wot, Wwt, Wwt, Ds, Ds, Wwg, Wwg, Ss, Wwg, Gg, Gg, Ss, Gg^Ftr, Gg^Ftr, Gg, Gg, Gg, Gg, Gg^Ftr, Gg^Ftr, Gg, Gg, Gg, Wwg, Gg, Gg, Gg^Ft, Gg, Gg^Ft, Gg^Ft, Gg, Gg, Gg, Gg, Gg, Gg, Gg, Gg, Gg, Gg, Gg
Wot, Wot, Wwt, Wwt, Wwt, Wwg, Ds, Gg, Gg, Gg, Gg, Gg, Gg, Ss, Ss, Gg, Gg, Gg, Gg, Gg, Gg, Gg, Gg, Gg, Gg, Gg, Hh, Gg, Gg, Gg, Gg, Gg^Ft, Gg, Gg, Gg, Gg, Gg, Gg, Gg, Gg, Gg, Gg
Wot, Wwt, Wwt, Wwt, Wwt, Ds, Ds, Ds, Ds, Gg, Gg, Gg, Gg, Gg, Gg, Gg, Gg, Gg^Ftr, Gg, Gg^Ft, Gg, Gg^Ft, Gg, Gg, Gg, Gg^Ft, Hh^Ft, Gg^Ft, Gg, Gg, Gg, Gg, Gg, Gg^Vl, Gg, Gg, Ce, Gg, Gg, Gg, Gg, Gg
Wwt, Wwt, Wwt, Wwt, Wwt, Wwt, Wwt, Wwt, Wwt, Ds, Ds, Ds, Gg, Gg, Gg, Gg, Gg, Gg, Gg^Ft, Gg, Gg, Gg, Gg, Gg^Ft, Gg, Hh, Gg^Ft, Hh, Gg, Gg, Gg, Gg, Gg, Gg, Gg, Ce, Ket, Ce, Gg, Gg, Gg, Gg
Wwt, Wwt, Wwt, Wwt, Wwrt, Wwt, Wwt, Ww^Vm, Wwt, Wwt, Wwt, Ds, Ds, Gg, Gg^Ftr, Gg, Gg, Gg, Gg, Gg^Ft, Gg^Ft, Gg^Ft, Gg^Ft, Gg^Ft, Gg^Ft, Gg^Ft, Gg^Ftr, Gg, Gg, Gg, Gg, Gg, Gg, Gg, Rb, Ce, Ce, Ce, Gg, Gg^Vct, Gg, Gg
Wwt, Wwt, Wwt, Wwt, Wwt, Wwt, Cme, Wwt, Cme, Wwt, Wwt, Ds, Gg, Gg^Ftr, Gg^Ftr, Gg, Gg, Gg, Gg, Gg^Ftr, Rb, Gg^Vc, Gg^Ft, Gg, Gg^Ft, Gg, Gg, Gg, Rb, Gg, Rb, Gg, Rb, Rb, Gg, Gg, Gg, Gg, Gg, Gg, Gg, Gg
Wwt, Wwt, Wwt, Wwt, Wwt, Cme, Cme, Km, Cme, Cme, Wwt, Ds, Gg, Gg, Rb, Rb, Rb, Rb, Rb, Gg, Rb, Gg, Gg^Ft, Gg, Gg^Ft, Gg, Rb, Rb, Rb, Rb, Gg, Rb, Gg, Gg, Gg, Gg, Gg, Gg, Gg, Gg, Gg, Gg
Wwt, Wwt, Wwt, Wwt, Ww^Vm, Wwt, Wwt, Wwt, Wwt, Wwt, Wwt, Ds, Rb, Rb, Gg, Gg, Gg, Gg, Gg, Rb, Rb, Gg, Gg^Ft, Gg^Ft, Gg, Rb, Rb, Gg, Gg, Gg, Gg, Gg, Gg, Gg, Gg, Gg, Gg, Gg, Gg^Ftr, Gg, Gg^Ftr, Gg
Wwt, Wwt, Wwt, Wwt, Wwt, Wwt, Wwt, Wwt, Wwt, Wwt, Ds, Ds, Gg, Gg, Gg, Gg, Gg^Ftp, Gg^Ftp, Gg, Gg, Gg, Rb, Rb, Gg, Rb, Rb, Gg, Gg, Gg, Gg, Gg, Gg, Gg, Gg, Gg, Gg, Gg, Gg^Ftr, Gg^Ftr, Gg^Ftr, Gg^Ftr, Gg
Wwt, Wwt, Wwt, Wwt, Wwt, Ds, Ds, Wwt, Wwt, Wwt, Ds, Ds, Gg, Gg, Gg, Gg^Ftp, Gg^Ftp, Gg, Gg, Gg, Gg, Gg, Gg, Rb, Gg, Gg, Gg, Gg, Gg, Gg, Gg, Gg, Gg, Gg, Gg, Gg, Gg^Ftr, Gg^Ftr, Gg^Ftr, Gg^Ftr, Gg, Gg^Ftr
Wwt, Wwt, Ds, Ds, Ds, Ds, Ds, Ds, Ds, Ds, Gg, Ds, Gg, Gg, Gg, Gg^Ftp, Gg, Gg, Gg, Gg, Gg, Gg, Gg, Gg, Gg, Gg, Gg, Gg, Gg, Gg, Gg, Gg, Gg, Gg, Gg, Gg, Gg, Gg^Ftr, Gg^Ftr, Gg^Ftr, Gg^Ftr, Gg^Ftr
