Hhd, Hhd, Hhd, Gg, Gg, Gg, Gg, Gg, Gg, Gg, Gg, Gg, Gg, Gg, Gg, Gg, Gg, Gg, Gg, Gg, Gg, Gg, Gg, Gg, Md, Md, Md, Md, Md, Md, Md, Md, Md, Gg, Gg, Gg
Hhd, Hhd, Ce, Ce, Ce, Gg, Gg, Gg, Gg, Gg, Gg, Gg, Gg, Gg, Gg, Gg, Gg, Gg, Gg, Gg, Md, Gg, Md, Md, Md, Md, Md, Md, Md, Md, Md, Md, Md, Gg, Gll^Fp, Gg
Hhd, Hhd, Ce, Ke, Ce, Gg, Gg, Gg, Gg, Gg, Mm, Mm, Mm, Mm, Mm, Mm, Mm, Mm, Mm, Md, Md, Md, Md, Md, Md, Md, Md, Md, Md, Md, Md, Md, Md, Gll^Fp, Md, Gll^Fp
Hhd, Hhd, Re^Vct, Ce, Gg, Gg, Md, Md, Md, Md, Md, Mm, Mm, Mm, Mm, Mm, Mm, Mm, Mm, Md, Md, Md, Mm, Md, Md, Md, Ms, Md, Md, Gll^Fp, Md, Md, Md, Md, Md, Md
Gg, Gs^Fds, Hhd, Gg, Gg, Hhd, Md, Md, Md, Md, Gd^Vo, Mm, Mm, Mm, Mm, Mm, Mm, Mm, Mm, Mm, Mm, Mm, Mm, Mm, Ms, Ms, Ms, Ms, Ms, Md, Md, Gll^Fp, Md, Md, Md, Md
Gg, Gs^Fds, Gg, Gg, Hhd, Hhd, Hhd, Md, Md, Md, Md, Md, Md, Mm, Mm, Mm, Mm, Mm, Mm, Mm, Mm, Gll^Fp, Mm, Gd^Vo, Ms, Ms, Ms, Ms, Ms, Ms, Md, Md, Md, Md, Md, Md
Gg, Gs^Fds, Gg, Gg, Hhd, Hhd, Hhd, Hhd, Hhd, Md, Md, Md, Md, Mm, Mm, Ai, Mm, Mm, Mm, Mm, Mm, Mm, Mm, Mm, Ms, Ms, Ms, Ms, Ms, Ms, Ms, Md, Md, Md, Md, Md
Gg, Gs^Fms, Gs^Fms, Gs^Fms, Gs^Fms, Gd^Vo, Mm, Hhd, Hhd, Cte, Kte, Cte, Hh, Hh, Hh, Ww, Hh, Hh, Hh, Mm, Mm, Mm, Mm, Mm, Mm, Ms, Ms, Ms, Ms, Ms, Ms, Ms, Md, Md, Md, Md
Gg, Gs^Fms, Gs^Fms, Gs^Fms, Gs^Fms, Mm, Mm, Mm, Mm, Cte, Mm, Cte, Hh, Hh, Gs, Ww, Ww, Hh, Hh, Mm, Mm, Mm, Mm, Mm, Mm, Mm, Mm, Ms, Kte, Ha, Ha, Ms, Md, Md, Md, Gg
Gg, Gs^Fms, Gs^Fms, Gs^Fms, Gs^Fms, Mm, Mm, Mm, Mm, Mm, Mm, Gd^Vo, Hh, Gs, Wwrg, Ww, Wwrg, Gd^Vo, Hh, Mm, Mm, Mm, Mm, Mm, Hh, Ms^Xm, Hh, Cte, Ha, Ha, Ha, Ms, Ms, Md, Md, Md
Gg, Gg, Gs^Fms, Gs^Fms, Gs^Fms, Mm, Mm, Mm, Mm, Mm, Mm, Hh, Hh, Gs, Wwrg, Wwrg, Wwrg, Gs, Hh, Mm, Hh, Mm, Hh, Hh, Hh, Hh, Hh, Cte, Cte, Ha, Aa^Fma, Ms, Ms, Md, Md, Md
Gg, Gg, Gg, Gg, Mm, Mm, Mm, Mm, Mm, Mm, Mm, Hh, Hh, Gs, Ww, Wwrg, Gs, Gs, Gs, Hh, Mm, Hh, Gll^Fdf, Hh, Gd^Vo, Hh, Hh, Hh, Hh, Cte, Ms, Ms, Ms, Mm, Mm, Gg
Gg, Gg, Gg, Gg, Mm, Mm, Mm, Mm, Mm, Mm, Gg, Hh, Ww, Ww, Hh, Hh, Gll^Fmf, Gs, Gs, Mm, Mm, Mm, Mm, Gs, Gs, Gs, Gll^Fp, Hh, Hh, Hh, Ms, Ms, Mm, Mm, Mm, Mm
Gg, Gg, Gs, Gg, Mm, Mm, Mm, Mm, Hhd, Hhd, Ww, Ww, Mm, Hh, Hh, Hh, Hh, Gll^Fmf, Hh, Hh, Mm, Mm, Gll^Fdf, Gs, Hh, Hh, Hh, Hh, Hh, Mm, Mm, Mm, Mm, Mm, Mm, Mm
Gg, Gg, Gg, Gs^Fds, Gs^Fds, Mm, Mm, Mm, Ww, Ww, Hhd, Mm, Mm, Mm, Mm, Hh, Gd^Vo, Hh, Hh, Mm, Mm, Mm, Hh, Hh, Hh, Hh, Hh, Hh, Hh, Mm, Mm, Mm, Mm, Mm, Mm, Mm
Gg, Gs, Gg, Gs^Fds, Mm, Mm, Mm, Mm, Ww, Gd^Vo, Mm, Mm, Mm, Mm, Mm, Mm, Mm, Mm, Mm, Hh, Hh, Hh, Gll^Fmw, Gll^Fmw, Gll^Fmw, Hh, Hh, Gll^Fmf, Mm, Mm, Mm, Mm, Mm, Mm, Mm, Mm
Gg, Gg, Gg, Gs^Fds, Mm, Mm, Gs, Gll^Fp, Ww, Mm, Mm, Mm, Ms^Xm, Mm, Ms^Xm, Mm, Mm, Mm, Mm, Mm, Hh, Hh, Hh, Gll^Fp, Gll^Fp, Hh, Hh, Hh, Hh, Mm, Hh, Mm, Mm, Mm, Mm, Mm
Gg, Gg, Gg, Gg, Ww, Ww, Ww, Ww, Mm, Ww, Mm, Mm, Mm, Ms^Xm, Ms^Xm, Ms^Xm, Mm, Mm, Mm, Mm, Hh, Hh, Hh, Hh, Hh, Hh, Hh, Hh, Hh, Hh, Hh, Hh, Hh, Mm, Mm, Mm
Gg, Gg, Ww, Ww, Ww, Mm, Mm, Mm, Mm, Mm, Mm, Mm, Mm, Ms^Xm, Mm, Mm, Mm, Mm, Mm, Mm, Hh, Hh, Hh, Cer, Ker, Gd^Vo, Md, Md, Ms^Xm, Hh, Hh, Hh, Hh, Hh, Mm, Mm
Ww, Ww, Gg, Gg, Gg, Ww, Ww, Mm, Mm, Mm, Mm, Mm, Mm, Mm, Gs, Gll^Fmw, Ww, Hh, Ww, Gs, Ww, Hh, Hh, Cer, Cer, Cer, Md, Md, Ms, Ms, Ms, Hh, Hh, Gd^Vo, Gll^Fdf, Mm
Gg, Gg, Gs^Fds, Gg, Gg, Gg, Ww, Gg, Gs, Mm, Mm, Mm, Mm, Mm, Ww, Ww, Mm, Ww, Gll^Fmf, Ww, Ww, Ww, Ww, Hh, Ww, Ww, Ww, Ai, Ai, Ms, Ms, Hh, Hh, Hh, Hh, Hh
Gg, Gs^Fds, Ce, Ce, Ce, Gg, Gg, Ww, Ww, Gg, Gg, Gg, Ww, Ww, Gs, Gs, Gd^Vo, Gll^Fmf, Mm, Mm, Mm, Mm, Hh, Ww, Hh, Hh, Gs, Ww, Md, Ms, Md, Gll^Fmf, Hh, Hh, Hh, Hh
Gg, Gs^Fds, Ce, Ket, Ce, Gg, Re^Vct, Gg, Gg, Ww, Ww, Ww, Hh, Hh, Mm, Mm, Mm, Mm, Mm, Mm, Mm, Mm, Mm, Hh, Hh, Hh, Hh, Gs, Gll^Fmf, Md, Gs^Fms, Hh, Hh, Hh, Mm, Mm
Gg, Gs^Fds, Gg, Ce, Gg, Gg, Gg, Gg, Gg, Gg, Gg, Gg, Hh, Mm, Mm, Mm, Mm, Mm, Mm, Mm, Mm, Mm, Mm, Mm, Mm, Mm, Mm, Gll^Fmf, Gs^Fms, Gd^Vo, Gll^Fmf, Hh, Mm, Hh, Mm, Mm
Gs^Fds, Gs^Fds, Gs^Fds, Gg, Gg, Gg, Gg, Gg, Gs^Fds, Gs^Fds, Gg, Hh, Hh, Mm, Mm, Mm, Mm, Mm, Mm, Mm, Mm, Mm, Mm, Mm, Mm, Mm, Mm, Mm, Mm, Mm, Mm, Mm, Mm, Mm, Mm, Mm
Gg, Gs^Fds, Gg, Gg, Gg, Gg, Gg, Gs^Fds, Gs^Fds, Gs^Fds, Gg, Hh, Gg, Mm, Mm, Mm, Mm, Mm, Mm, Mm, Ms, Mm, Mm, Mm, Ms, Ms, Mm, Mm, Mm, Mm, Mm, Mm, Mm, Mm, Mm, Mm
