Xu, Xu, Xu, Xu, Xu, Xu, Xu, Xu, Xu, Xu, Xu, Xu, Xu, Xu, Xu, Xu, Xu, Xu, Xu, Xu, Xu, Xu, Xu, Xu, Xu, Xu, Xu, Xu, Xu, Xu, Xu, Xu, Xu, Xu, Xu, Qxua, Qxua, Qxua, Qxu, Qxu, Qxu, Qxu, Qxu, Qxua, Qxua, Qxua
Xu, Xu, Xu, Xu, Xu, Xu, Xu, Xu, Xu, Xu, Xu, Xu, Uu^Em, Xu, Uu, Xu, Uu, Xu, Xu, Xu, Xu, Xu, Xu, Xu, Xu, Xu, Xu, Xu, Xu, Xu, Xu, Xu, Xu, Xu, Xu, Qxua, Qxua, Qxua, Uu, Qxu, Rb, Qxu, Qxu, Qxua, Qxua, Qxua
Xu, Xu, Xu, Xu, Xu, Xu, Xu, Xu, Xu, Xu, Uu, Uu, Uu, Uu, Cud, Uu, Uu, Uu^Vu, Xu, Xu, Xu, Xu, Xu, Xu, Uh, Xu, Xu, Xu, Xu, Xu, Xu, Xu, Xu, Xu, Uu, Uu, Uu^Vu, Uu, Uu^Em, Cte, Cte, Kte, Cte, Qxu, Xu, Qxu
Xu, Xu, Xu, Xu, Xu, Xu, Xu, Xu, Xu, Qxu, Uu, Uu, Uu^Em, Cud, Rb, Cud, Cud, Uu, Uu, Xu, Xu, Xu, Xu, Xu, Ql, Uu, Xu, Xu, Xu, Xu, Ur, Xu, Xu, Xu, Uh, Uu, Ur, Uu, Ur, Cte, Uu^Dr, Cte, Uu, Xu, Xu, Xu
Xue, Xu, Xu, Xu, Xu, Ql, Ql, Xu, Xu, Uu, Uu, Uu^Edb, Uu, Cud, Cud, Kud, Cud, Uu, Uu, Xu, Xu, Xu, Ql, Ql, Rb, Xu, Uu, Uu, Uu, Ur, Xu, Ur, Ur, Xu, Uu, Uu, Uu, Uu, Uu, Uu, Uu, Cte, Uu, Xu, Xu, Xu
Xu, Xu, Xu, Xu, Uu, Uu, Ql, Xu, Xu, Uu, Uu^Es, Uu, Ur, Qxua, Qxua, Cud, Uu, Uu, Xu, Xu, Ql, Ql, Co, Uu, Ko, Co, Uu, Uu, Uh, Xu, Xu, Xu, Xu, Ur, Xu, Ur, Uu, Uu^Dr, Uu, Uu, Uu, Uu, Uu, Xu, Xu, Xu
Xu, Xu, Xu, Xu, Uu, Uu, Ql, Xu, Xu, Xu, Uh, Uu, Uu, Ur, Ur, Uu, Uu, Uu, Xu, Ql, Xu, Uu, Uu, Co, Co, Co, Co, Ur, Uu, Xu, Xu, Xu, Xu, Xu, Xu, Xu, Xu, Uu^Em, Uu, Uu, Uu^Vu, Ur, Uu, Xu, Xu, Xu
Xu, Xu, Xu, Xu, Xu, Xu, Xu, Ql, Ql, Ql, Ql, Uu, Xu, Uu, Uu, Uu^Edb, Uu, Uu^Vu, Xu, Ql, Xu, Ql, Uu, Uu, Uu, Uu, Uu, Uu, Rr^Vd, Uu, Xu, Xu, Xu, Xu, Xu, Xu, Xu, Xu, Uu, Uu, Ur, Ur, Uu, Xu, Xuc, Xuc
Xue, Xu, Xu, Xu, Xu, Xu, Uu, Xu, Ql, Uu, Xu, Ql, Ql, Xu, Uu, Uu, Xu, Xu, Xu, Ql, Ql, Xu, Ql, Uu, Uu, Uu, Uu^Uf, Ur, Uu, Uu, Uu, Uh, Uu, Xu, Xu, Xu, Qxu, Xu, Xuc, Uu, Ur, Uu, Uu^Uf, Xuc, Xuc, Xuc
Xuc, Xue, Xu, Xu, Uu, Uu, Uu, Uu, Rr^Vd, Uh, Xu, Xu, Ql, Xu, Uu, Xu, Xu, Xu, Xu, Ql, Xu, Ql, Ql, Uu, Ur, Uh, Ur, Ur, Xu, Uu, Uu, Uu, Uu, Uu, Qxu, Qxu, Xuc, Qxu, Qxu, Uu, Uu, Uu, Uu, Xuc, Xuc, Xuc
Xuc, Xu, Xu, Xu, Uu, Uh, Uu, Uu, Uu, Xu, Xu, Xu, Ql, Ur, Ql, Uu, Uu, Xu, Xu, Xu, Xu, Ql, Ql, Uu, Uu^Edb, Ur, Uu, Xu, Uu, Uh, Xu, Xu, Xu, Uu, Qxu, Uu, Uu^Vud, Xuce, Xuc, Qxu, Qxu, Uu, Xuc, Xuc, Xuc, Xuc
Xu, Xu, Xu, Uu, Uu, Uu, Chr, Uu, Uu, Uu, Ur, Ur, Xu, Ql, Uu, Ql, Ql, Xu, Xu, Xu, Xu, Xu, Ql, Uu, Uu, Uu, Rr^Vd, Ur, Ur, Uu, Xu, Xu, Xu, Qxu, Uu, Uu, Uu, Qxua, Qxua, Cud, Uu, Xuc, Xuc, Xuc, Xuc, Xuc
Xu, Xu, Xu, Uu, Rr^Vd, Chr, Khr^Ii, Chr, Ur, Ur, Uh, Xu, Ql, Ql, Uu, Xu, Xu, Ql, Ql, Ql, Ql, Ql, Xue, Uu, Uu, Uu, Uu, Uu, Xu, Ur, Uu, Xu, Xu, Qxu, Xu, Xu, Uu, Co, Uu, Uu, Xuc, Xuc, Xuc, Xuc, Xuc, Xuc
Xu, Xu, Xu, Uu, Uu, Chr, Rb, Chr^Ii, Uu^Ii, Uu, Uu, Xu, Ql, Ql, Uu, Xu, Xu, Xu, Ql, Xu, Xu, Xu, Xue, Xue, Xue, Xue, Xue, Xue, Xuc, Uu, Qxu, Xu, Qxu, Qxu, Uu, Xu, Ur, Uu, Xu, Xu, Xuc, Xuc, Xuc, Xuc, Xuc, Xuc
Xu, Xu, Xu, Uu, Uu, Chr, Chr, Chr^Ii, Uu, Uu, Uu, Uu, Uu, Uu, Xu, Xu, Xu, Xu, Wot, Wot, Uh, Uu, Xue, Xue, Xue, Xue, Xuc, Xuc, Qxu, Qxu, Uu, Ur, Xu, Qxua, Xue, Xu, Uu, Xu, Xu, Xuc, Xuc, Xuc, Uu, Uu^Uf, Xu, Xuc
Xu, Xu, Xu, Xu, Xu, Uu, Uu, Ur, Uu, Uu, Uu, Uu, Xu, Xu, Xu, Xu, Wot, Wot, Xu, Wot, Wot, Wot, Xuc, Xuc, Xuc, Xuc, Xuc, Xuc, Xu, Xu, Xu, Ur, Ur, Xu, Xu, Xu, Ur, Xu, Xu, Xuc, Xu, Xu, Wot, Wot, Wot, Xu
Xue, Xu, Xue, Xu, Xu, Xu, Xu, Uu, Xu, Xu, Xu, Xu, Xue, Xu, Wot, Wot, Xue, Xu, Xu, Xuc, Xue, Wot, Xuc, Xuc, Xu, Xuc, Xu, Xu, Rr^Vd, Xu, Xu, Xu, Uu, Cud, Uu, Ur, Xu, Ur, Uu^Vu, Xu, Wot, Wot, Xu, Xu, Xu, Wot
Xue, Xue, Xue, Xu, Xu, Xu, Xu, Ur, Wot, Xu, Wot, Xue, Wot, Wot, Xue, Wot, Xue, Xu, Uu^Dr, Xu, Xu, Wot, Wot, Xu, Uu, Xu, Xue, Xu, Ur, Ur, Ur, Uu, Xu, Uu, Xu, Uu, Uu, Uu, Wot, Wot, Uu, Xu, Xuc, Xuc, Xuc, Xuc
Xue, Xue, Xue, Xue, Xu, Xu, Xu, Ur, Uu, Wot, Wot, Wot, Xue, Xue, Xue, Xue, Xu, Xu, Uu, Xu, Xu, Xu, Uu, Wot, Ww^Vm, Uu, Xu, Xu, Xue, Xu, Ur, Xu, Xu, Xu, Xu, Xu, Wwg, Wot, Uu, Uu, Uu, Uu, Xuc, Xuc, Xuc, Xuc
Xue, Xue, Xue, Xue, Xu, Xu, Xu, Ur, Ur, Xu, Xu, Uu, Uu, Xue, Xu, Xue, Xu, Uu^Uf, Uu^Ii, Uh, Uu, Uh, Xu, Xu, Xu, Wot, Xu, Xu, Xu, Xu, Ur, Uu^Dr, Wwg, Wwg, Wwg, Wwg, Xuc, Xuc, Xuc, Qxua, Xuc, Uu, Uu, Xuc, Xuc, Xuc
Xue, Xue, Xue, Xue, Xu, Xu, Xu, Ur, Uu, Xu, Cud, Xu, Uu, Xu, Xu, Xu, Xu, Uu, Xuc, Uu, Xuc, Uu, Xuc, Xuc, Xu, Wot, Wot, Xu, Wot, Wot, Wot^Bw|, Wot, Wot, Xuc, Uu, Uu, Xuc, Xuc, Xuc, Xuc, Xuc, Xuc, Uu, Xuc, Xuc, Xuc
Xue, Xue, Xue, Xue, Xue, Xue, Xu, Xuc, Xu, Uu, Kud, Uu, Uu, Uu^Vud, Uu, Xu, Qxu, Qxu, Xuc, Xuc, Xuc, Xuc, Xuc, Xuc, Xuc, Xu, Wog, Wot, Rp^Vhcr, Chw, Khr, Wot, Uu, Xuc, Xuc, Xuc, Xuc, Uh, Uu, Xuc, Cud, Xuc, Ur, Xuc, Xuc, Xuc
Xuc, Xue, Xue, Xue, Xue, Xue, Xu, Xu, Uu, Cud, Ur, Uu, Uu, Uu, Qxu, Qxu, Uu, Xuc, Xuc, Xuc, Xuc, Xuc, Xuc, Xuc, Xuc, Xuc, Uu, Wot, Wot^Bw/, Chr, Wot, Wot, Uu, Uh, Xuc, Xuc, Ur, Uu, Xuc, Uu, Uu, Ur, Uu, Uu^Vu, Xuc, Xuc
Xuc, Xue, Xue, Xue, Xue, Xu, Cud, Uu, Qxu, Uu, Qxu^Bp\, Qxu, Qxu, Qxu, Cud, Uh, Uu, Uu, Xuc, Xuc, Xuc, Xuc, Xuc, Xuc, Xuc, Xuc, Xuc, Ur, Uu, Wot, Wot, Wot, Xuc, Uu, Uu, Ur, Uu, Xuc, Xuc, Uu, Ur, Uu, Uu, Uu, Xuc, Xuc
Xue, Xue, Xue, Xue, Xue, Xu, Uu^Vud, Uu, Qxu, Uu, Qxu, Qxu^Bp\, Ur, Ur, Ur, Uu, Xuc, Xuc, Xuc, Xuc, Xuc, Xuc, Xuc, Xuc, Xuc, Xuc, Xuc, Ur, Uu^Vu, Xuc, Xuc, Xuc, Xuc, Xuc, Ur, Rr^Vd, Xuc, Xuc, Xuc, Uu, Ur, Uu, Uu, Uu, Xuc, Xuc
Xue, Xue, Xue, Xue, Xu, Xu, Uh, Uu, Qxu, Qxu, Uu, Uu, Uu, Uu, Xuc, Ur, Ur, Xuc, Ur, Xuc, Uu, Xuc, Xuc, Xuc, Xuc, Xuc, Xuc, Ur, Ur, Xuc, Xuc, Xuc, Xuc, Uu, Uh, Xuc, Xuc, Xuc, Xuc, Uu^Vu, Uu, Ur, Chr, Chr, Qxua, Xuc
Xue, Xue, Xue, Xue, Xu, Uu, Ur, Qxu, Qxu, Xuc, Xuc, Uu^Vu, Xuc, Xuc, Xuc, Xuc, Xuc, Ur, Xuc, Ur, Ur, Uu, Xuc, Xuc, Xuc, Xuc, Xuc, Uu, Ur, Xuc, Xuc, Xuc, Xuc, Ur, Cud, Xuc, Xuc, Xuc, Xuc, Xuc, Xuc, Uu, Chr, Khr, Qxua, Xuc
Xue, Xue, Xue, Xue, Xu, Uu, Uu, Ur, Qxu, Xuc, Xuc, Xuc, Xuc, Xuc, Xuc, Xuc, Xuc, Uu, Xuc, Xuc, Cud, Ur, Uu, Xuc, Xuc, Xuc, Xuc, Xuc, Ur, Xuc, Xuc, Xuc, Uu, Ur, Uu, Uu, Uu, Xuc, Xuc, Xuc, Xuc, Qxua, Qxua, Qxua, Xuc, Xuc
Xue, Xue, Xue, Xue, Xue, Xu, Xuc, Qxu, Qxu, Ur, Xuc, Xuc, Xuc, Xuc, Xuc, Xuc, Xuc, Uu, Xuc, Xuc, Xuc, Ur, Ur, Uu^Vud, Ur, Ur, Ur, Ur, Xuc, Xuc, Xuc, Uu, Uu, Uu, Uu^Ii, Uu^Ii, Uu, Uu, Xuc, Xuc, Xuc, Xuc, Xuc, Xuc, Xuc, Xuc
Xue, Xue, Xue, Xue, Xu, Xue, Xuc, Xuc, Qxu, Uu, Uu, Xuc, Uu, Xuc, Xuc, Xuc, Uu, Ur, Uu, Xuc, Xuc, Xuc, Xuc, Ur, Xuc, Xuc, Xuc, Uu, Qxua, Xuc, Xuc, Uu^Vud, Uu, Ur, Uu, Ur, Uu, Uu^Vud, Xuc, Xuc, Xuc, Xuc, Xuc, Xuc, Xuc, Xuc
Xue, Xu, Xu, Xu, Uu, Uu, Qxu, Qxu, Xuc, Qxu, Xuc, Ur, Uu, Uu, Uu, Ur, Xuc, Xuc, Xuc, Ur, Ur, Xuc, Uu, Ur, Uu, Xuc, Xuc, Uu, Xuc, Xuc, Xuc, Uu, Uu, Uu, Cud, Uu, Uu, Uu, Xuc, Xuc, Xuc, Xuc, Xuc, Xuc, Xuc, Xuc
Xu, Xu, Xu, Xu, Uu, Uu, Qxu, Xuc, Xuc, Xuc, Xuc, Ur, Uu^Vu, Xuc, Xuc, Xuc, Xuc, Xuc, Xuc, Xuc, Xuc, Uu, Uu, Ur, Uu, Uu, Uu, Uu, Xuc, Xuc, Xuc, Xuc, Xuc, Cud, Kud, Cud, Xuc, Xuc, Xuc, Xuc, Xuc, Xuc, Xuc, Xuc, Xuc, Xuc
Xu, Xu, Xu, Xu, Xu, Uu, Xu, Xuc, Xuc, Xuc, Xuc, Xuc, Xuc, Xuc, Xuc, Xuc, Xuc, Xuc, Xuc, Xuc, Xuc, Xuc, Uu, Ur, Cud, Uu, Xuc, Xuc, Xuc, Xuc, Xuc, Xuc, Xuc, Xuc, Xuc, Xuc, Xuc, Xuc, Xuc, Xuc, Xuc, Xuc, Xuc, Xuc, Xuc, Xuc
Xu, Xu, Xue, Xu, Xu, Xu, Xuc, Xuc, Xuc, Xuc, Xuc, Xuc, Xuc, Xuc, Xuc, Xuc, Xuc, Xuc, Xuc, Xuc, Xuc, Xuc, Uu, Ur, Uu, Xuc, Xuc, Xuc, Xuc, Xuc, Xuc, Xuc, Xuc, Xuc, Xuc, Xuc, Xuc, Xuc, Xuc, Xuc, Xuc, Xuc, Xuc, Xuc, Xuc, Xuc
Xuc, Xue, Xue, Xue, Xuc, Xuc, Xuc, Xuc, Xuc, Xuc, Xuc, Xuc, Xuc, Xuc, Xuc, Xuc, Xuc, Xuc, Xuc, Xuc, Xuc, Xuc, Xuc, Ur, Xuc, Xuc, Xuc, Xuc, Xuc, Xuc, Xuc, Xuc, Xuc, Xuc, Xuc, Xuc, Xuc, Xuc, Xuc, Xuc, Xuc, Xuc, Xuc, Xuc, Xuc, Xuc
