Rp, Gg, Xos, Xos, Xos, Gg, Xos, Gg, Xos, Gg, Xos, Gg, Xos, Gg, Xos, Gg, Xos, Gg, Xos, Gg, Xos, Gg, Rp, Rp, Rp, Rp, Rp, Rp, Rp
Rp, Xos, Xos, Xos, Xos, Xos, Xos, Xos, Xos, Xos, Xos, Xos, Xos, Xos, Xos, Xos, Xos, Xos, Xos, Xos, Xos, Xos, Rp, Rp, Rp, Rp, Rp, Rp, Rp
Rp, Xos, Xos, Xos, Xos, Xos, Xos, Xos, Xos, Xos, Xos, Xos, Xos, Xos, Xos, Xos, Xos, Xos, Xos, Xos, Xos, Xos, Rp, Rp, Gg^Efm, Gg^Fet, Gg^Efm, Rp, Gg
Rp, Xos, Xos, Xos, Xos, Xos, Iwr, Xos, Iwr, Xos, Iwr, Xos, Iwr, Xos, Iwr, Xos, Iwr, Xos, Iwr, Xos, Xos, Xos, Gg^Efm, Gg^Fet, Rrc, Rrc, Rrc, Gg^Fet, Gg
Rp, Iwr, Iwr, Xos, Xos, Xos, Iwr, Iwr, Iwr, Iwr, Iwr, Iwr, Iwr, Iwr, Iwr, Iwr, Iwr, Iwr, Iwr, Xos, Xos, Xos, Rrc, Rrc, Rrc, Rrc, Rrc, Rrc, Rrc
Rp, Xos, Xos, Iwr, Iwr, Iwr, Iwr, Iwr, Iwr, Iwr, Iwr, Iwr, Iwr, Iwr, Iwr, Iwr, Iwr, Iwr, Iwr, Xos, Xos, Xos, Rrc, Rrc, Rrc, Rrc, Rrc, Rrc, Rrc
Rp, Rp, Rp, Xos, Xos, Iwr, Iwr, Iwr, Icn, Icn, Icn, Icn, Icn, Icn, Icn, Icn, Icn, Icn, Icn, Iwr, Iwr, Rrc, Rrc, Rrc, Rrc, Rrc, Rrc, Rrc, Rrc
Rp, Rp, Rp, Rp, Rp, Xos, Iwr, Iwr, Iwr, Icn, Iwr, Icn, Iwr, Icn, Iwr, Icn, Iwr, Icn, Iwr, Iwr, Xos, Xos, Gg^Efm, Rrc, Rrc, Rrc, Rrc, Rrc, Gg
Rp, Rp^Eff, Rp^Eff, Rp, Rp, Xos, Iwr, Iwr, Iwr, Iwr, Iwr, Iwr, Iwr, Iwr, Iwr, Iwr, Iwr, Iwr, Iwr, Xos, Xos, Xos, Rp, Gg^Fet, Gg^Efm, Rrc, Gg^Efm, Gg^Fet, Rp
Rp, Rp, Rp, Rp^Eff, Rp^Eff, Xos, Iwr, Iwr, Iwr, Iwr, Iwr, Iwr, Iwr, Iwr, Iwr, Iwr, Iwr, Iwr, Iwr, Xos, Xos, Xos, Rp, Rp, Rp, Gg^Fet, Rp, Rp, Rp
Rp, Rp, Rp^Eff, Rp^Eff, Rp, Xos, Xos, Xos, Xos, Xos, Xos, Xos, Xos, Xos, Xos, Xos, Xos, Xos, Xos, Xos, Xos, Xos, Rp, Rp, Rp, Rp, Rp, Rp, Rp
Rp, Rp, Rp, Rp^Eff, Rp^Eff, Rp, Rp, Rp, Rp^Eff, Rp, Rp, Rp, Rp, Rp, Rp, Rp, Rp, Rp, Rp, Rp, Rp, Rp, Rp, Rp, Ww^Ewf, Ww^Ewf, Ww^Ewf, Rp, Rp
Rp, Rp, Rp, Rp, Rp, Rp^Eff, Rp^Eff, Rp^Eff, Gs, Rp^Eff, Rp^Eff, Rp, Rp, Rp, Rp, Rp, Rp, Rp, Rp, Rp, Rp, Rp, Rp, Rp, Rp, Ww^Ewf, Rp, Rp, Rp
Gg, Rp, Rp, Rp, Rp, Rp, Rp, Rp^Eff, Rp, Gs, Gs, Rp^Eff, Rp, Rp, Rp, Rp, Rp, Rp, Rp, Rp, Rp, Rp, Rp, Rp, Rp, Rp, Rp, Rp, Rp
