Wo, Wo, Wo, Wo, Wo, Wo, Wo, Ww, Ww, Ww, Ww, Gg, Gg, Gg, Gg, Gg, Gg, Gg, Gg, Gg, Gg, Gg, Gg, Gg, Gg, Gg, Gg, Gg, Hh, Gg, Hh, Gg, Gg, Gg, Gg, Gg, Gg, Gg, Gg, Gg, Gg, Gg, Gll^Fmf, Gg, Gg, Gg, Gg
Wo, Wo, Wo, Wo, Wo, Wo, Wo, Ww, Ww, Ww, Ww, Ds, Gg, Gg^Es, Gg, Gg, Gs^Fms, Gs^Fms, Gs^Fms, Gs^Fms, Gs^Fms, Gs^Fms, Gg, Gg, Gg, Gg, Gd^Vo, Hh, Hh, Hh, Hh, Hh, Gd^Vo, Gg, Re^Vct, Gg, Gg, Gg, Gg, Gll^Fmf, Gll^Fmf, Gll^Fmf, Gg, Gg, Gg, Gg, Gg
Wo, Wo, Wo, Wo, Wo, Wo, Wo, Ww, Ww, Ww, Ww, Ds, Ds, Gg, Gg, Gs^Fms, Gg, Gs^Fms, Gs^Fms, Gs^Fms, Gs^Fms, Gs^Fms, Gs^Fms, Gg, Gg, Gg, Gg, Gg, Co, Co, Co, Hh, Gg^Ecf, Gg, Gg^Edt, Gg, Gg, Gd^Vo, Gg, Gll^Fmf, Hh, Hh, Hh, Gg, Gg^Edt, Gg, Gg
Wo, Wo, Wo, Wo, Wo, Wo, Wo, Ww, Ww, Ww, Ww, Ds, Rb, Rb, Rb, Gs^Fms, Gs^Fms, Gs^Fms, Gg, Gs^Fms, Gs^Fms, Gs^Fms, Gs^Fms, Gg, Gg, Re^Vct, Gg^Edt, Co, Co, Ko, Co, Co, Gg, Gg, Gd^Vo, Gg, Gg, Gs^Fms, Gg, Gll^Fmf, Gg, Hh, Hh, Gd^Vo, Gg, Gg, Gg
Wo, Wo, Wo, Wo, Wo, Wo, Wo, Wo, Ww, Ww, Ww, Ds, Rb, Rb, Rb, Gg, Gg, Gs^Fms, Gs^Fms, Gs^Fms, Gs^Fms, Gs^Fms, Gs^Fms, Gg, Gg, Gg, Gd^Vo, Gg, Gg, Co, Gg, Gg, Gd^Vo, Gg, Gg, Gg, Gg, Gs^Fms, Gg, Gg, Gg, Co, Co, Co, Co, Gd^Vo, Gg
Wo, Wo, Wo, Wo, Wo, Wo, Wo, Wo, Ww, Ww, Ww, Ds, Ds, Rb, Gg, Gg^Es, Gg, Gg, Gg, Gg, Gg, Gs^Fms, Gg, Gg, Gg, Gg, Gg, Gg, Gg, Gg, Gg, Gg, Gg, Gg, Gg, Gg, Gg, Gg, Gg, Re^Vct, Gg^Ecf, Gg, Co, Ko, Co, Gg, Gg
Wo, Wo, Wo, Wo, Wo, Wo, Wo, Wo, Wo, Ww, Ww, Ww, Ds, Ds, Gg, Gg, Re^Gvs, Re^Gvs, Re^Gvs, Re^Es, Re^Gvs, Re^Gvs, Re^Gvs, Gg, Gg, Gs^Fp, Gs^Fp, Gs^Fp, Re^Gvs, Re^Gvs, Re^Gvs, Re^Gvs, Rr, Gg, Gg^Es, Gg, Gg, Re, Re, Gg, Gg, Gg^Edt, Gg, Co, Gg, Co, Gg
Wo, Wo, Wo, Wo, Wo, Wo, Wo, Wo, Wo, Ww, Ww, Ww, Ww, Ds, Ds, Ch, Gg^Vh, Re^Gvs, Re^Gvs, Re^Gvs, Re^Gvs, Re^Gvs, Re^Gvs, Re^Gvs, Rr, Gs^Fp, Gg, Gg, Gg^Vh, Re^Gvs, Re^Gvs, Rr, Re^Gvs, Re^Gvs, Gg^Vh, Gg, Re, Re, Re, Gg, Gg, Re^Vct, Gg, Gg, Gg^Edt, Gg, Gg
Wo, Wo, Wo, Wo, Wo, Wo, Wo, Wo, Wo, Ww, Ww, Ww, Ww, Ds, Ds, Gg, Re^Gvs, Rr, Rr, Gs^Wm, Re^Gvs, Re^Gvs, Re^Gvs, Rr, Gg^Vh, Rr, Rr, Rr, Rr, Rr, Rr, Rr, Rr, Re^Gvs, Gg, Gg, Re, Re, Gg, Gg, Gg, Gg, Gg, Gg, Gg, Gg, Gg
Wo, Wo, Wo, Wo, Wo, Wo, Wo, Wo, Wo, Ww, Ww, Ww, Ww, Ds, Ds, Ch, Re^Gvs, Re^Gvs, Re^Gvs, Rr, Gg^Vh, Ch, Rr, Ch, Ds, Gg, Ds, Ch, Ds, Gg, Ch, Gg, Gg, Rr, Gg, Gg, Gg, Gg, Gs^Fp, Gg, Gg, Gg, Gg^Es, Gg, Gg, Gg, Gg
Wo, Wo, Wo, Wo, Wo, Wo, Wo, Wo, Wo, Ww, Ww, Ww, Ww, Ww, Ds, Ds, Gg, Re^Gvs, Rr, Ch, Ds, Ds, Ww^Bw|, Ds, Ww^Bw|, Ww^Bw/, Ds, Ds, Ww^Bw/, Ds, Ds, Ds, Gg^Vh, Rr, Rr, Gg, Re^Gvs, Gll^Fmw, Gg^Efm, Gg, Gg, Gg, Gg, Gg, Hh, Gg, Gg
Wo, Wo, Wo, Wo, Wwrt, Wwrt, Wo, Wo, Wo, Wo, Ww, Wwr, Ww, Ww, Ds, Ds, Ch, Rr, Gg, Ds, Ww, Ww, Ww^Bw|, Ww, Ww^Bw|, Ww, Ww^Bw|, Ww^Bw/, Ww, Ww, Ww^Bw/, Ds, Ch, Gg, Rr, Re^Gvs, Re^Gvs, Re^Gvs, Gg^Efm, Gg, Gg, Gg, Hh, Hh, Gll^Fmw, Gg, Gg
Wo, Wo, Wo, Wwrt, Wo, Wwrt, Wo, Wo, Wo, Wo, Wo, Ww, Ww, Ww, Dd, Ds, Ch, Ch, Ds, Ww^Bw\, Ww^Bw|, Ww, Ww^Bw|, Ww, Wo^Bw|, Ww, Wo^Bw|, Ww, Ww^Bw|, Ww^Bw/, Ww, Ds, Ds, Gg, Rr, Re^Gvs, Re^Gvs, Re^Gvs, Gg, Gg, Gg, Gg, Hh, Gll^Fmw, Gll^Fmw, Gg, Gg
Wo, Wo, Wo, Wo, Wo, Wwrt, Wo, Wo, Wo, Wo, Wo, Ww, Ww, Ww, Dd^Ftd, Ds, Kh, Ds, Ww, Ww, Ww^Bw|, Ww, Wo, Ww, Wo, Wo, Wo, Ww, Ww, Ww, Ww^Bw\, Ww, Ds, Gg, Rr, Gg, Gg, Gg^Vh, Gg, Gg, Gg, Hh, Gll^Fmw, Gll^Fmw, Gg, Gg, Gg
Wo, Wo, Wo, Wo, Wo, Wo, Wo, Wo, Wo, Wo, Wo, Ww, Ww, Ds, Ds, Ds, Ch, Ds, Ww, Ww, Ww, Ww, Wo, Wo, Wo, Wo, Wo, Wo, Ww^Bw\, Ww, Ww, Ww^Bw\, Ds, Ch, Gg, Rr, Gg, Gg, Re, Gg, Gg, Gg, Gg, Gg, Gg, Gg, Gg
Wo, Wo, Wo, Wo, Wo, Wo, Wo, Wo, Wo, Wo, Wo, Ww, Ww, Ds, Ds, Ds^Es, Ch, Ch, Ww, Ww, Ww, Wo, Wo, Wo, Wo, Ww, Wo^Bw\, Wo, Ww, Ww^Bw|, Ww^Bw\, Ds, Gg, Gg, Re, Rr, Gs^Vl, Gg, Gg, Gg, Rb^Gvs, Rb^Gvs, Rb^Gvs, Gg, Gg, Gg, Gg
Wo, Wo, Wo, Wo, Wo, Wo, Wo, Wo, Wo, Wo, Wo, Ww, Ww, Ww, Ww, Ds, Ww, Ds, Ww, Ww, Ww, Wo, Ww, Ww, Ww^Bw/, Ww^Bw/, Ww, Ww^Bw\, Ww^Bw\, Ww, Ds, Gg, Kh, Ch, Re, Rr, Re, Re, Gs^Fp, Gg, Gg, Rb^Gvs, Rb^Gvs, Rb^Gvs, Gg, Gg, Gg
Wo, Wo, Wo, Wo, Wo, Wo, Wo, Wo, Wo, Wo, Wo, Wo, Wo, Ww, Ww, Ww, Ww, Ww, Ww, Ww, Wo, Wo, Ww, Ww, Ww, Ww, Ds, Ww, Ds, Ww^Bw\, Ds, Ch, Ch, Ch, Rr, Rr, Gs^Fp, Gll^Fmw, Gs^Fp, Gg, Gg, Gg, Gg, Gg, Gg, Gg, Gg
Wo, Wo, Wo, Wo, Wo, Wo, Wo, Wo, Wo, Wo, Wo, Wo, Wo, Ww, Ww, Ww^Vm, Ww, Ww, Ww, Wo, Wo, Wo, Ww, Ww, Ww, Ds, Ch, Ds, Ds, Ds, Ch, Gg, Gg, Re, Rr, Gs^Fp, Gll^Fmw, Gs^Fp, Re, Gg, Gg, Gg, Wwg, Wwg, Wwg, Gg, Gg
Wo, Wo, Wo, Wo, Wo, Wo, Wo, Wo, Wo, Wo, Wo, Wo, Wo, Wo, Wo, Ww, Wo, Wo, Wo, Wo, Wo, Ww, Ww, Ww, Ww, Ch, Ds, Ds, Ds, Ds^Es, Ds, Gg^Efm, Gg, Gg, Rr, Gg, Gg^Vh, Re, Re, Gg, Gg, Ss, Wwg, Ww^Ewf, Gg^Eff, Gg^Eff, Gg
Wo, Wo, Wo, Wo, Wo, Wo, Wo, Wo, Wo, Wo, Wo, Wo, Wo, Wo, Wo, Wo, Wo, Wo, Wo, Wo, Wo, Ww, Ww, Ww, Ww, Ww, Ww, Ww, Ww, Ds, Ww, Ds, Ds, Ch, Gg, Rr, Rr, Gg, Gg, Gg^Es, Ww, Wwg, Gg^Eff, Gg^Eff, Gg^Eff, Gg, Gg
Wo, Wo, Wo, Wo, Wo, Wo, Wo, Wo, Wo, Wo, Wo, Wo, Wo, Wo, Wo, Wo, Wo, Wo, Wo, Wo, Wo, Wo, Wo, Ww, Ww, Ww, Ww, Ww, Ww, Ww, Ww, Ds, Ww, Ds, Ds, Gg, Ch, Rr, Gg, Ww, Gg, Gg, Gg, Gs^Vh, Gg^Gvs, Gg, Gg
Wo, Wo, Wo, Wo, Wo, Wo, Wo, Wo, Wo, Wo, Wo, Wo, Wo, Wo, Wo, Wo, Wo, Wo, Wo, Wo, Wo, Wo, Wo, Ww, Ww, Ww^Vm, Ww, Ww, Ww, Ww, Ww, Ww, Wo, Ww, Ww, Ds, Gg, Gg^Efm, Re^Gvs, Ww, Gg, Gg, Gg^Gvs, Gg^Gvs, Gg^Gvs, Gg^Gvs, Gg
Wo, Wo, Wo, Wo, Wo, Wo, Wo, Wo, Wo, Wo, Wo, Wo, Wo, Wo, Wo, Wo, Wo, Wo, Wo, Wo, Wo, Wo, Wo, Wo, Wo, Ww, Wo, Wo, Wo, Wo, Wo, Wo, Wo, Wo, Ww, Ds, Gg, Re^Gvs, Ww, Ww, Ss, Gg, Gg, Gg^Gvs, Gg, Gg, Gg
Wo, Wo, Wo, Wo, Wo, Wo, Wo, Wo, Wo, Wo, Wo, Wo, Wo, Wo, Wo, Wo, Wo, Wo, Wo, Wo, Wo, Wo, Wo, Wo, Wo, Wo, Wo, Wo, Wo, Wo, Wo, Wo, Wo, Wo, Ww, Ww, Ww, Re^Gvs, Ww, Ss, Gg, Gg, Gg, Gg, Gg, Gg, Gg
Wo, Wo, Wo, Wo, Wo, Wo, Wo, Wo, Wo, Wo, Wo, Wo, Wo, Wo, Wo, Wo, Wo, Wo, Wo, Wo, Wo, Wo, Wo, Wo, Wo, Wo, Wo, Wo, Wo, Wo, Wo, Wo, Wo, Wo, Ww, Ww, Ww, Ww, Ss, Ss, Gg, Gg, Gg, Gg, Gg, Gg, Gg
Wo, Wo, Wo, Wo, Wo, Wo, Wo, Wo, Wo, Wo, Wo, Wo, Wo, Wo, Wo, Wo, Wo, Wo, Wo, Wo, Wo, Wo, Wo, Wo, Wo, Wo, Wo, Wo, Wo, Wo, Wo, Wo, Wo, Ww, Ds, Ww, Ww, Ww, Re^Gvs, Gg, Gg, Gg, Gg, Gg, Gg, Gg, Gg
Wo, Wo, Wo, Wo, Wo, Wo, Wo, Wo, Wo, Wo, Wo, Wo, Wo, Wo, Wo, Wo, Wo, Wo, Wo, Wo, Wo, Wo, Wo, Wo, Wo, Wo, Wo, Wo, Wo, Wo, Wo, Wo, Wo, Ww, Ds, Ds, Re^Gvs, Re^Gvs, Re^Gvs, Gg, Gg, Gg, Gg, Gg, Gg, Gg, Gg
