Wo, Wo, Wo, Wo, Wo, Wo, Wo, Wo, Wo, Wo, Wo, Wo, Wo, Wo, Wo, Wo, Ww, Gg, Gg, Gg, Gg, Gg, Gg, Gg, Gg, Gs^Fds, Gg, Gg, Gg, Gg, Gg, Gg, Gg, Gg, Gg, Gg, Hhd, Gg, Md, Gg, Md, Gg, Md, Gg, Ms, Gg
Wo, Wo, Wo, Wo, Wo, Wo, Wo, Wo, Wo, Wo, Wo, Wo, Wo, Wo, Wo, Wo, Ww, Ds, Ds, Gg, Gg, Gg, Gg, Gs^Fds, Gs^Fds, Gs^Fds, Gg, Gg, Gg, Gg, Gg, Gg, Gg, Gg, Gg, Gg, Hhd, Md, Md, Md, Md, Md, Cte, Ms, Ms, Ms
Wo, Wo, Wo, Wo, Wo, Wo, Wo, Wo, Wo, Wo, Wo, Wo, Wo, Wo, Ww, Ww^Vm, Ww, Ww, Ds, Dd, Dd^Do, Gg, Gg, Gs^Fds, Gg, Gg, Gg, Gg, Gg, Gg, Ww, Gg, Gg, Gg, Gg, Gg, Hhd, Hhd, Hhd, Md, Md, Cte, Kte, Aa^Voa, Ms, Ms
Wo, Wo, Wo, Wo, Wo, Wo, Ww, Wo, Wo, Wo, Ww, Ww, Ww, Ww, Ww, Ww, Ww, Ww, Ww, Ds, Ds, Gg, Chs, Gg, Ww, Ww, Ww, Ww, Ww, Ww^Ewf, Ww, Ww, Ss, Gg, Gg, Gg, Gg, Hhd, Hhd, Md, Md, Cte, Cte, Cte, Md, Ms
Wo, Wo, Wo, Wo, Ww, Ww, Dd, Dd, Ww, Ww, Wo, Wo, Cm, Cm, Km, Ww, Cm, Ww, Wwr, Ww, Ww, Ww, Ss^Vhs, Ss, Gg, Rp, Rp, Gg, Gg, Gg, Gg^Efm, Ww, Ww, Gg, Gg, Gg, Gg, Hhd, Hhd, Hhd, Hhd, Hhd, Md, Md, Md, Ms
Wo, Wo, Wo, Ww, Ww, Dd, Hd, Hd, Ww, Ww, Ww, Wo, Cm, Wwr, Cm, Cm, Wo, Ww, Ww, Ww, Wwr, Ww, Ww, Chs, Gg, Gg^Edb, Gg, Gg, Gg, Gs^Vht, Gg, Ww^Ewf, Gg, Gg, Gg, Gg, Gg, Gg, Gg, Hhd, Md, Md, Md, Md, Md, Md
Wo, Wo, Wo, Ww, Ww, Dd, Hd^Vda, Ww, Gd, Dd, Ww, Wo, Wwr, Wwr, Wo, Ww, Ww, Wo, Ds, Ww, Ww, Ww, Ww, Chs, Gg, Gg, Gg, Rp, Gg, Gg, Gs^Fms, Gg, Gg, Gg, Hhd, Gg, Gg, Gg^Es, Gg, Hhd, Hhd, Md, Md, Md, Md, Md
Wo, Wo, Wo, Wo, Wwrt, Hd, Ww, Ww, Wwrt, Ds, Ww, Ww, Wo, Ww^Vm, Wwrt, Wo, Wo, Ww, Gg, Ds, Ds, Gg, Gg, Ww, Ww, Gg, Gg, Rp, Gg, Gg, Gs^Fms, Gs^Fms, Hhd, Hhd, Gg, Gg, Gg, Gg, Gg, Hhd, Hhd^Es, Hhd, Hhd, Md, Ww, Ww
Wo, Wo, Wo, Wo, Ww, Ww, Ww, Ds, Ds, Dd^Ftd, Ww, Ww, Ww, Wo, Wo, Wo, Ww, Ww, Gg, Gg, Gg, Gg, Gg, Gg, Gg, Ww, Gg, Gg, Gg, Gs^Fms, Gs^Fds, Gs^Fms, Gs^Fms, Hhd, Gs^Fms, Gg, Gg, Gg^Efm, Gg, Gg, Gg, Hhd, Hhd, Ww, Hhd, Md
Wo, Wo, Wo, Wo, Wo, Ww, Ww, Ww, Ww, Ww, Ww, Ww, Ww, Wo, Wwr, Wwr, Ww, Ww, Ds, Gg, Gg^Es, Gg, Gg, Gg, Ce, Ww, Ww, Rp, Gg, Gs^Fds, Gs^Fds, Gg^Fet, Chr^Fds, Gs^Fms, Gs^Fds, Gs^Fms, Gs^Fms, Gs^Fms, Gg, Gg, Gg, Gg, Ww, Ww, Hhd, Hhd
Wo, Wo, Wo, Wo, Wo, Wo, Wwr, Ww, Wwr, Ww, Wo, Wo, Wo, Wwr, Wwr, Ww, Ww, Ds, Gg, Gg, Gg, Gg, Gg, Ce, Ke, Gg, Rp, Ww, Gg, Gs^Fms, Gs^Fms, Gs^Fds, Gs^Fds, Gs^Fds, Gs^Fms, Gs^Fms, Gs^Fms, Gs^Fms, Gg, Gg, Ww, Ww, Gg, Hhd, Hhd, Hhd
Wo, Wo, Wo, Wo, Wo, Wo, Wo, Ww, Wo, Wo, Wo, Wo, Wo, Wo, Wo, Ww, Ww, Ds, Gg, Gg, Gg, Gg, Gg, Ce, Gg, Rp, Re^Vct, Ww, Ww, Gg, Gg, Gs^Fms, Gg, Gs^Fms, Gg, Gs^Fms, Ww, Ww, Ww, Ww, Gg, Gg, Gg, Gg, Gg, Hhd
Wo, Wo, Wo, Wo, Wo, Wo, Wo, Wo, Wo, Wo, Wwrt, Wo, Wo, Wo, Wo, Wwr, Ds, Ds, Dd^Vda, Gg, Gg, Gg, Gg, Ce, Ce, Rp, Ce, Ce, Ww, Gg, Gg, Gg, Ww, Gg, Ww, Ww, Gg, Gg, Gg, Gg, Gg, Gs^Fms, Gll^Fmf, Gg, Gg, Gg
Wo, Wo, Wo, Wo, Wo, Wo, Wo, Wo, Wwrt, Wwrt, Wo, Wo, Wo, Wo, Ww, Ww, Wwr, Ds, Ds, Gg^Es, Gg, Gg, Gg, Gg, Rp, Rp, Gg, Gg, Gg, Ww, Ww, Ww, Gg, Ww, Gg, Gg, Gg, Gg, Gg, Gg^Es, Rp, Gs^Vht, Gs^Fds, Gg, Gg, Gg
Wo, Wo, Wo, Wo, Wo, Wo, Wo, Wo, Wo, Wwrt, Wo, Wo, Wo, Wo, Ww, Wwr, Wwr, Ds, Dd^Dc, Gg, Gg, Gg, Gg, Rp, Gg, Gg, Gg, Gg, Gg, Gg, Gg, Gg, Gg^Es, Gg, Gs^Fms, Gs^Fms, Gs^Fds, Gg, Rp, Rp, Gg, Gg, Gg, Gg, Gg, Gg
Wo, Wo, Wo, Wo, Wo, Wo, Wo, Wo, Wo, Wo, Wo, Wo, Wo, Wo, Ww, Wwr, Ww, Ds, Ds, Gg, Hhd, Hhd, Gg, Rp, Cud, Gg, Cud, Gg, Gg, Gg, Gg, Gg, Gg, Gg, Gs^Fms, Hh, Hh, Gs^Fds, Hh, Gg, Gg, Gg, Gg^Es, Gg, Gg, Gg
Wo, Wo, Md, Ch, Ch, Wo^Bw/, Wo, Wo, Wo, Wo, Ww, Wo, Ww, Ww, Ww, Ww, Ww, Ww, Dd^Ftd, Gg, Hhd, Hhd, Cud, Rr, Rr, Cud, Rr^Vd, Cud, Cud, Gg, Gg, Gg, Rp, Rp, Gs^Vh, Gs^Fms, Hh, Hh, Gs^Fms, Gg, Gg, Gg, Gg, Gg, Gg, Gg
Wo, Wo, Hhd, Kh, Ch, Ww, Ww, Wo, Ww, Ww, Cdr, Ww, Ww, Ww, Ww, Wo, Ww, Ww, Dd^Ftd, Gs^Ftp, Cud, Cud, Rr, Rr^Vd, Rr, Rr, Rr, Rr, Rr^Vd, Cud, Rr, Rp, Gg, Gg, Gg, Gg, Gg, Gs^Fms, Gg, Gg, Gg, Gg, Gg, Gg, Ww, Ww
Wo, Wo, Wo, Hhd, Ch, Ww, Ww, Ww, Dd^Ftd, Dd^Vda, Cdr, Ww, Ww, Ww, Ww, Wo, Ww, Ww, Rr, Cud, Rr, Rr^Vd, Rr, Rr, Rr^Vd, Rr, Mm, Rr, Rr, Rr, Cud, Gg, Gg, Gg, Ww, Ww, Ww, Gg, Ww, Ww, Ww, Ss, Ww, Ww, Gg, Gg
Wo, Wo, Wo, Ch, Wo, Wo^Bw\, Wo^Bw\, Ww, Dd^Ftd, Ds, Dd^Ftd, Cdr, Ww, Wwr, Wwr, Ww, Ww, Ww, Ww, Rr, Rr^Vd, Md, Md, Cud, Cud, Cud, Rr, Mm, Hhd, Rr, Uu^Vud, Cud, Ww, Ww, Gg, Gg, Gg, Ww, Gg, Ss, Ss^Vhs, Ww, Gg, Gg, Gg, Gg
Wo, Wo, Wo, Wo, Wo, Wo, Ww, Hd, Dd^Vda, Ds, Kdr, Cdr, Ww, Wwr, Wo, Wwr, Ds, Wwr, Ww, Rr, Rr, Md, Rr, Rr^Vd, Kud, Rr^Vd, Rr, Md, Rr, Rr, Cud, Cud, Ww, Gg, Gg, Gg, Gg, Gg, Gg, Gg, Gg, Gg, Gs^Fds, Gg, Gs^Fds, Gg
Wo, Wo, Wo, Wo, Wo, Ww, Ww, Hd, Hd, Hd, Ww, Ww, Ww, Wo, Wo, Wo, Wo, Wwr, Wwr, Rr, Rr^Vd, Rr, Rr, Cud, Rr^Vd, Cud, Rr, Rr, Rr, Cud, Ww, Ww, Gg, Gg, Gg, Gg, Gg, Gg, Gg, Gg, Gs^Fds, Gs^Fds, Gs^Fms, Gg, Gs^Fms, Gg
Wo, Wo, Wo, Wo, Wo, Wo, Ww, Ww, Ww, Ds, Ww, Ww, Wo, Ww, Ww, Wo, Wo, Ww, Ww, Ww, Cud, Rr, Rr, Rr, Rr, Rr, Rr^Vd, Cud, Ww, Ww^Bsb\, Rp, Gg, Gg, Gg, Gg, Gg, Gg, Gg, Gg, Gs^Fms, Gg, Gs^Fms, Gs^Fds, Gs^Fms, Gs^Fms, Gg
Wo, Wo, Wo, Wo, Wo, Wo, Wo, Ww, Ww, Ds, Ds, Wo, Wo, Ds, Ds, Wo, Ww, Ww, Ww, Ww, Ww, Cud, Cud, Rr^Vd, Rr, Rr, Cud, Cud, Ww, Gg, Gg, Rp, Rp, Gg, Gg, Gg, Gg, Gg, Gs^Fms, Gs^Fms, Gs^Fds, Gs^Fds, Gs^Fds, Gll^Fmf, Gs^Fms, Gg
Wo, Wo, Wo, Wo, Wo, Wo, Wo, Wo, Wo, Ww, Ww, Ww, Wo, Wo, Ww, Ww, Wo, Ww, Ww, Ww, Gg, Ww, Ww, Cud, Ww^Bsb|, Cud, Ww, Ww, Gg, Gg, Gg, Gg, Gg, Rp, Rp, Gg, Gg, Gg, Gs^Fds, Gs^Fms, Gll^Fmf, Gg, Gs^Fms, Gs^Fms, Gg, Gg
Wo, Wo, Wo, Wo, Wo, Wo, Wo, Wo, Wo, Wo, Ww, Ww, Ww, Wo, Ww, Wo, Wo, Ww, Ww, Ww, Gg, Gg, Gg, Ww, Rp, Ww, Gg, Gg, Gg, Gg, Gg, Gg, Gg, Gg, Gg, Gg, Gg, Gg, Gs^Fds, Gs^Fds, Gs^Fds, Gs^Fms, Gg, Gs^Fms, Gs^Fds, Gg
Wo, Wo, Wo, Wo, Wo, Wo, Wo, Wo, Wo, Wo, Wwf, Ww, Wo, Ww, Ww, Ww, Ww, Ww, Ww, Ww, Gg, Gg, Gg, Gg, Rp, Gg, Gg, Gg, Gg, Gg, Gg, Gg, Hh, Gg, Hh^Vhh, Gg, Gg, Gg, Gg, Gg, Gg, Gs^Fds, Gs^Fds, Gs^Fms, Gg, Gs^Fds
Wo, Wo, Wo, Wo, Wo, Wo, Wo, Wo, Wo, Wo, Wwf, Ww, Wo, Wo, Wo, Ww, Wo, Wo, Ww, Ww, Gg, Gg, Gg, Gg, Rp, Gg, Gg, Gg, Hh, Hh, Hh, Hh, Hh, Hh, Mm, Hh, Gg, Gg, Gg, Gg, Gg, Gg, Gg, Gg, Gg, Gg
Wo, Wo, Wo, Wo, Wo, Wo, Wo, Wo, Ww, Wo, Ww, Ww, Wo, Wo, Wo, Ww, Wo, Ww, Ww, Gg, Gg, Gg, Rp, Rp, Gs^Fds, Rp, Rp, Gg, Hh, Mm, Hh, Gll^Fmf, Mm, Mm, Hh, Hh, Gg, Gg, Gg, Gg, Gg, Gg, Gs^Fds, Gg, Hh, Hh
Wo, Wo, Wo, Wo, Wo, Wo, Hhd, Hhd, Md, Ww, Ww, Ww, Wo, Wo, Ww, Ww, Ww, Ww, Wwf, Gg, Gg, Rp, Gg, Gg, Ce, Gg, Re^Vct, Rp, Gg, Hh, Gs^Fms, Hh, Hh, Hh, Gg, Gg, Gg, Gg, Gg, Gg, Gg, Gs^Fds, Hh, Hh, Gs^Fds, Hh
Wo, Wo, Wo, Wo, Wo, Wo, Gd^Vc, Md, Md, Wwr, Wwr, Ww, Wwf^Vm, Ww, Wwf, Ww, Ww, Ww, Ds, Ds, Hd, Gg, Gs^Fds, Ce, Ket, Gg, Gs^Fms, Rp, Gg, Gg, Gg, Gg, Gg, Gg, Gg, Gg, Gg, Gg, Hh, Gg, Hh, Hh, Hh^Vo, Hh, Md, Md
Wo, Wo, Wo, Wo, Wo, Wo, Wo, Gd, Wwr, Wwr, Ww, Ww, Ww, Wwf, Ww, Ww, Ww, Wwf, Ww, Ds, Dd^Vda, Gg, Gg, Ce, Ce, Gs^Fms, Gg, Rp, Gg, Gg, Gg, Gg, Gg, Gg, Gg, Gg, Hh, Hh, Hh, Hh, Co, Hh, Co, Co, Md, Md
Wo, Wo, Wo, Wo, Wo, Wo, Wo, Wo, Wo, Ww, Ww, Ww, Ww, Ww, Ww, Wwf, Ww, Ww, Ww, Ds, Ds, Gg, Gg, Gg, Gg, Gs^Fds, Gg, Rp, Gg, Gg, Gg, Gg, Gg, Gg, Gg, Hh, Hh, Hh, Hh, Hh^Vo, Hh, Co, Ko, Md, Md, Md
Wo, Wo, Wo, Wo, Wo, Wo, Wo, Wo, Wo, Wo, Wo, Ww, Ww, Ww, Ww, Ww, Ww, Ww, Ww, Ds, Ds, Gg, Gg, Gg, Gg, Gg, Gg, Rp, Gg, Gg, Gg, Gg, Gg, Gg, Hh, Hh, Gs^Fds, Hh, Hh, Hh, Md, Co, Md, Md, Md, Md
Wo, Wo, Wo, Wo, Wo, Wo, Wo, Wo, Wo, Wo, Wo, Wo, Wo, Ww, Ww, Ww, Wo, Ww, Ds, Ds, Gg, Gg, Gg, Gg, Gg, Gg, Gg, Rp, Gg, Gg, Gg, Gg, Gg, Gg, Hh, Hh, Hh, Gs^Fds, Gg, Md, Md, Md, Md, Md, Md, Md
