border_size=1
usage=map

Rd, Rd, Gd, Gd, Gd, Dd, Gs, Ww, Hhd, Gs, Rr, Hhd, Hhd, Gd, Gd, Gd, Gll^Fp, Gs^Edb, Gs^Edb, Gd, Rr, Rr
Gd, Rd, Rd, Hhd, Ds^Fts, Gd, Gd, Gs, Gd, Ds, Rr, Hhd, Md, Mm, Hhd^Vhhr, Hhd^Edb, Chr, Re^Vct, Chw, Gd, Rr, Gs
Hhd, Hhd, Md, Rd, Rd, Gd, Gd, Gd, Dd, Dd^Ftd, Rr, Hhd, Dd^Fp, Mm, Hhd, Hh, Hh^Edb, 2 Khs, Ss, Rd^Edt, Rp, Gd
Ds^Fts, Hhd, Md, Hhd, Hhd, Rd, Rd, Rd, Rd, Rr, Dd^Ftd, Dd^Es, Gd, Dd^Fdw, Dd^Edb, Hh^Edb, Ss, Chs, Ww^Ewf, Ds, Rp, Gd
Hhd, Hhd, Ww^Ewl, Hhd, Gd, Dd^Ftd, Ss, Ss, Wwt, Rp, Wwt, Ss, Ss, Gs, Ss, Dd^Edb, Ww^Ewl, Wwt, Wwt, Wwt, Wwt^Bsb|, Ds
Gd, Hhd, Gd, Ds, Dd^Es, Dd, Ss, Ww^Ewf, Wot, Wwt^Bsb|, Cd, Wot, Wot, Wo, Wot, Wwt, Wot, Wwt, Wot, Wwt, Wwt^Bsb|, Wwt
Ds^Fts, Hhd, Hhd, Gd, Gd, Hh, Hh, Wot, Gg^Ve, 3 Kd, Dd^Vda, Wwt^Bsb\, Cd, Kd, Wwt^Bsb\, Wot, Hhd^Ve, Wot, 1 Kv, Cv, Rp, Wwt
Dd, Ds^Fts, Ds, Gd, Ss, Gs, Wwt, Wwt, Cd^Xo, Rrc, Wwt^Bsb\, Wot, Wot, Wot, Rb^Gvs, Rp, Wwt^Bsb\, Wwt, Hh, Rr, Gs^Efm, Gs
Wwt, Ds, Ww^Ewf, Ss, Wwt, Wwt, Ww^Ewl, Cd^Xo, Wot, Wot, Rb^Gvs, Rp, Ww^Bsb\, Gg^Ve, Rb^Gvs, Ss, Wwt, Rp, Rr, Rr, Ds^Fts, Gs
Wwt, Wwt, Wwt, Wwt, Wwt, Wot, Wot, Wot, Wwt, Hhd^Vwm, Wwt, Rb^Gvs, Wwt, Rp, Wwt^Bsb\, Wwt, Wwr, Dd^Em, Rr, Rd, Rd, Rd
Wwt, Wwt, Wwt, Wwt, Ds^Fts, Hd, Ww^Ewf, Wwt, Hd, Wwt, Hh, Wwt, Ww^Ewl, Wwt, Dd^Ftd, Rp, Rr, Rr, Gs, Ds^Fts, Gs^Efm, Ds^Fts
Gs, Wwt, Wwt^Bw/, Dd^Vda, Ds^Fts, Rb^Gvs, Gs^Efm, Ss, Gs, Dd^Ftd, Dd, Gs^Efm, Gs, Ss, Gs, Dd^Ftd, Rr, Gs^Efm, Ds^Fts, Gd^Efm, Gd^Efm, Gs
Gs, Wwt, Wwt, Ss, Gs, Gs, Gs^Efm, Gs^Efm, Gs, Gs^Efm, Gs^Efm, Gs^Efm, Gs, Gs^Efm, Gs, Gs^Efm, Rr, Gs, Ds^Fts, Gs, Ds^Fts, Gs
