Xue, Xue, Xos, Xos, Xol, Xue, Xue, Xue, Xue, Xue, Xue, Xue, Hhd^Ii, Hhd, Xue, Xuce, Xol, Xos, Rb, Xos, Xol, Xuce
Xol, Xol, Ur, 2 Kud, Cud, Xol, Xos, Xue, Xue, Xue, Xue, Xue, 3 Hhd^Vhhr, 1 Hhd^Ii, Xu, Xos, Ur, Ur, Wwf, Rb, Xos, Xuce
Xol, Ur, Ur, Ur, Ur, Rr^Vd, Xol, Xue, Xue, Xue, Xue, Xue, Xuce, Uue^Dr, Xuce, Xos, Xol, Ur, Xol, Rb^Dr, Ke^Vov, Xu
Xu, Xol, Ur, Ur, Xol, Xol, Xoc, Xoc, Xu, Xue, Xue, Xue, Ce, Ur^Br\, Ur^Br\, Xu, Xuc, Xol, Xuc, Uu, Re, Xu
Xu, Uu^Vu, Ur^Edt, Xol, Xu, Xoc, Xos, Xos, Xos, Xu, Xu, Xu, Xu, Ket, Ce, Ur^Br\, Uu^Br\, Xuce, Ur^Br/, Uu^Br/, Uue^Br\, Xu
Xu, Rd, Ur, Uu^Uf, Xos, Xos, Ke^Vov, Xv, Wwf^Ii, Xos, Xol, Xu, Xu, Xu, Xuc, Xuc, Re, Ur^Br\, Xu, Xuc, Xue^Br|, Xue
Xu, Xu, Ur^Edb, Xu, Xos, 5 Ket, Ce, Wwf, Wwf, Rp^Ecf, Ds, Wwr^Dr, Xu, Xuce, Wwf^Dr, Wwf, Xu, Xuc, Xos, Xos, Xol, Xuc
Xu, Uu, Ur, Rd, Uu, Xos, Xos, Rp, Xos, Xol, Wwf^Edt, Xue, Xuc, Xue, Xuc, Xuc, Ke^Vov, Xos, Urb, Urb, Urb, Xol
Xu, Uu^Uf, Xu, Wwf, Wwt, Wwf, Xu, Xos, Wwr^Dr, Wwf, Uu, Rb^Ecf, Ke^Vov, Xuc, Xue, Xue, Rb, Rb^Dr, Xos, Urb, Xos, Xol
Xu, Xu, Xu, Xu, Xu, Ur, Wwf^Edt, Xu, Xu, Wwf, Rb, Xuc, Xuc, Xuc, Rb, Xuc, Xu, Re, Uue^Dr, Xos, Xue, Xue
Xu, 4 Uue^Kov, Uue, Xu, Rb, Xu, Xu, Xu, Xu, Xu, Xu, Rb, Rb, Rb, Xu, Rb, Re, Xu, Xue, Xue, Xue, Xue
Xu, Uue^Cov, Uue, Uue^Edb, Wwf, Wwf, Wwf, Rb, Rb, Uue^Edb, Uue, Rb, Xue, Xu, Uue, Uue^Edb, Uue^Edb, Uue^Edb, Uue, Xue, Xue, Xue
Xue, Xu, Xu, Xu, Xu, Xue, Xu, Xue, Xue, Xue, Xue, Xu, Xue, Xu, Xu, Xue, Xu, Xu, Xue, Xue, Xue, Xue
