Gll^Fp, Gll^Fp, Gll^Fp, Gll^Fp, Gll^Fp, Gll^Fp, Ds^Ftd, Ds^Ftd, Ds^Ftd, Dd^Ftd, Ds^Efm, Dd^Ftd, Rd, Dd^Ftd, Dd^Ftd, Ds, Ds^Ftd, Ds^Ftd, Gll^Fp, Gll^Fp, Gll^Fp, Gll^Fp
Gll^Fp, Gll^Fp, Gll^Fp, Gll^Fp, Ds^Ftd, Ds^Ftd, Ds^Ftd, Ds^Ftd, Ds^Efm, Ds^Efm, Ds^Efm, Dd^Ftd, Rd, Dd^Ftd, Ds^Efm, Ds^Ftd, Ds^Ftd, Gll^Fp, Ds^Ftd, Gll^Fp, Gll^Fp, Gll^Fp
Gll^Fp, Gll^Fp, Ds^Ftd, Ds^Ftd, Ds^Ftd, Ds^Ftd, Dd^Ftd, Ds^Efm, Ds^Efm, Dd, Cd, Dd^Do, Kv, Ds^Efm, Ds^Gvs, Ds^Ftd, Ds^Ftd, Ds^Ftd, Gll^Fp, Gll^Fp, Gll^Fp, Gll^Fp
Gll^Fp, Gll^Fp, Gll^Fp, Ds^Ftd, Gll^Fp, Ds^Ftd, Ds^Ftd, Ds^Gvs, Rd, Cd, 1 Kd, Cv, Cv, Dd^Vda, Ds^Gvs, Ds^Efm, Ds^Ftd, Ds^Ftd, Gll^Fp, Gll^Fp, Gll^Fp, Gll^Fp
Gll^Fp, Gll^Fp, Gll^Fp, Gll^Fp, Gll^Fp, Ds^Ftd, Ds^Gvs, Dd^Vda, Ds^Efm, Cd, Rd, Ds^Efm, Rd, Ds^Efm, Rd, Rd, Rd, Rd, Rd, Gll^Gvs, Gll^Gvs, Gll^Fp
Ds^Ftd, Gll^Fp, Ds^Ftd, Gll^Fp, Ds^Ftd, Ds^Ftd, Ds^Ftd, Rd, Dd^Ftd, Ds^Efm, Rd, Dd^Ftd, Rd, Rd, Ds^Efm, Ds^Ftd, Ds^Ftd, Gll^Fp, Gll^Fp, Gs^Vh, Gll^Gvs, Gll^Fp
Ds^Ftd, Ds^Ftd, Ds^Ftd, Ds^Ftd, Ds^Fp, Ds^Fp, Ds^Ftd, Rd, Rd, Rd, Dd^Ftd, Rd, Rd, Dd^Ftd, Dd^Ftd, Ds^Efm, Ds^Ftd, Ds^Ftd, Gll^Fp, Rd, Gll^Fp, Gll^Fp
Ds, Ds^Ftd, Ds^Ftd, Ds^Ftd, Ds^Ftd, Ds^Ftd, Ds^Ftd, Rd, Gs^Efm, Gs^Em, Rd, Rd, Rd, Dd^Ftd, Ds^Efm, Dd^Ftd, Ds^Ftd, Gll^Fp, Ds^Ftd, Rd, Gll^Fp, Gll^Fp
Ds^Efm, Dd^Ftd, Ds^Efm, Ds^Efm, Ds^Efm, Ds^Ftd, Rd, Rd, Gs^Esd, Ww, Rd, Dd^Ftd, Rd, Dd^Ftd, Dd^Ftd, Ds^Efm, Ds^Efm, Ds^Ftd, Ds^Ftd, Rd, Ds^Ftd, Gll^Fp
Dd^Ftd, Dd^Ftd, Ds, Ds, Ds, Ds^Efm, Rd, Ss, Re, Re, Ss, Ds^Gvs, Rd, Rd, Rd, Ds, Dd^Ftd, Ds^Ftd, Ds^Ftd, Rd, Ds^Ftd, Gll^Fp
Ds, Ds^Efm, Ss, Ss, Ds^Esd, Ds^Gvs, Gs^Vh, Re, Gs, Rb, Ss, Gs^Vh, Ds^Gvs, Ds, Ww^Ewl, Rd, Rd, Dd^Ftd, Rd, Rd, Ds^Ftd, Gll^Fp
Ww, Ww, Ww^Ewf, Ww, Ww, Ww, Ww, Ww, Ww, Rb, Wo, Ww, Ww, Ww, Dd, Ss, Ss, Rd, Rd, Ds^Ftd, Dd^Ftd, Dd^Ftd
Gs^Ftp, Gs^Ftp, Gs^Ftp, Gs^Ftp, Ww, Wot, Wot, Wot, Ww, Ww^Bw|, Ww^Ewf, Wot, Wot, Ww, Ww, Ds^Esd, Ds, Gs^Ftp, Rd, Ds^Efm, Dd^Ftd, Dd^Ftd
Ww, Ww, Ww, Ww, Wot, Wot, Ss, Wot, Ds, Ww^Bw|, Ds, Ww, Wot, Wot, Wot, Ww, Wo, Wo, Gs^Vh, Ds^Gvs, Gll^Fp, Gd^Fts
Wot, Ww^Ewf, Wot, Wot, Wot, Ww^Ewl, Wot, Ds, Ww, Ds, Gs^Ft, Gs^Vh, Wot, Wot, Gg^Fet, Wot, Wot, Ww, Ww, Gll^Fp, Ww^Ewl, Ww
Wot, Wot, Wot, Wot, Wot, Wot, Wot, Wot, Ww, Ww^Bw|, Ww, Ww, Wot, Wot, Wot, Wot, Wot, Wot, Wot, Ww, Wot, Wot
Wot, Wot, Ww, Wot, Ww, Wot, Wot, Wot, Ww, Ww^Bw|, Ww, Ww, Wot, Wot, Wot, Wot, Wot, Wot, Ww, Ww, Wot, Wot
Ww, Ww, Dd^Ftd, Ds, Ds, Wwr, Ds, Ww, Wwr, Ww^Bw\, Rb, Wwr, Wwr, Wot, Ww, Ww, Wwr, Wot, Ww, Wot, Wot, Wot
Ds, Ds, Ds, Ds, Ds^Gvs, Ds, Ds, Ds, Ds, Wwr, Rb, Wwr, Ds, Wwr, Ds^Gvs, Ds, Ds, Ds, Rd, Wwr, Wwr, Ww
Ds, Dd^Ftd, Ds, Dd^Vda, Ds^Gvs, Dd^Vda, Dd^Ftd, Ds^Esd, Rd, Rd, Ds, Rd, Rd, Dd^Ftd, Dd^Vda, Ds^Gvs, Ds^Edpp, Rd, Ds, Ds, Dd^Ftd, Ds
Ds, Ds, Ds, Rd, Rd, Dd^Do, Rd, Rd, Ds, Ds, Ds, Ds, Ds, Rd, Rd, Rd, Rd, Rd, Ds, Ds, Ds, Ds
Ds, Dd^Ftd, Ds^Esd, Ds, Dd^Efm, Rd, Ds^Edpp, Ds, Ds, Dd^Ftd, Ds, Ds, Ds, Ds, Ds, Ds, Rd, Ds, Ds^Edpp, Ds, Ds^Esd, Ds
Ds, Ds, Ds, Ds, Gll^Fdw, Rd, Rd^Esd, Ds, Ds^Esd, Ds, Ds^Edp, Dd^Dc, Ds, Ds^Esd, Ds, Ds^Edpp, Ds, Rd, Rd, Ds^Edt, Ds^Edb, Ds
Gll^Ftd, Gll^Ftd, Gll^Ftd, Gll^Ftd, Gll^Edt, Ds, Rd, Ds, Ds, Ds, Ds, Ds, Rd, Ds, Rd, Ds, Rd, Rd, Ce, Dd^Vdt, Ds^Ecf, Ds
Gll^Ftd, Gll^Ftd, Gll^Fp, Gll^Fdw, Gll^Fdw, Ds, Ds, Rd, Rd, Ds, Rd, Rd, Ds, Rd, Ds, Rd, Rd, Ce, 2 Ke, Ce, Hd, Hd
Gll^Ftd, Gll^Ftd, Gll^Fp, Gll^Edt, Gll^Fdw, Gll^Fdw, Gll^Ecf, Ds, Ds^Edt, Rd, Dd^Ftd, Ds, Ds, Ds, Ds, Ds^Edt, Dd^Vdt, Ce, Ce, Dd^Do, Ds^Edb, Hd
Gs^Ft, Gll^Fp, Gll^Fdw, Gll^Fdw, Gll^Fdw, Gll^Edb, Re^Vct, Gll^Fdw, Ds, Rd, Ds, Ds, Ds, Ds^Esd, Ds, Ds, Ds, Ds^Ecf, Ds^Edt, Ds^Esd, Ds^Esd, Ds
Gll^Fp, Gs^Ft, Gll^Fp, Gll^Fp, Ds, Gll^Edb, Gll^Fp, Gll^Ftd, Ds, Rd, Ds, Ds, Ds, Ds, Ds, Ds, Ds, Ds^Esd, Ds, Ds, Ds, Ds
