Gs^Ft, Gs^Ft, Gs^Fds, Gs^Ft, Gs^Fds, Gs^Ft, Gs^Ft, Gs^Ft, Ww, Gs^Ft, Gs^Ft, Gs^Ft, Gs^Ft, Gs^Ft, Gs^Fds, Gs^Fds, Gll^Ftr, Gs^Ft, Gs^Ft, Gs^Fds, Gs^Fds, Gs^Fds, Rp, Gs^Fds, Gs^Ft, Gs^Ft, Gs, Gs, Gs, Gs, Gs, Gs, Gs, Gs, Gs, Rp, Hh, Gs^Ft, Gs^Ft, Gs^Ft, Gs, Gs, Hh, Hh, Rp, Rrc, Hhd, Hhd, Hhd, Hhd, Hhd, Gd^Fts, Mm, Hhd, Gd^Fts, Rr, Gd, Dd, Dd, Dd, Dd
Gs^Ft, Gs^Ft, Gs^Ft, Gs^Fds, Gs^Ft, Gs^Ft, Gs^Ft, Gs^Ft, Ww, Gs^Ft, Ds, Gs^Fds, Gs^Ft, Gs^Ft, Gs^Fds, Gs^Ft, Gs^Fds, Gs^Ft, Gs^Ft, Gs^Fds, Gs^Fds, Gs^Ft, Rp, Gs^Fds, Gs^Fds, Gs^Ft, Gs, Gs^Efm, Gs^Ft, Gs^Ft, Gs^Ft, Gs^Ft, Hh, Gs^Efm, Rp, Rp, Rp, Gs^Ft, Dd^Ftd, Hh, Rp, Hh, Rp, Rp, Ss, Rp, Gs^Efm, Gd^Efm, Gd^Efm, Gd, Gd^Efm, Hhd, Mm, Hhd, Gd^Fts, Rr^Efm, Gd^Fts, Dd, Dd, Dd^Do, Dd
Gs^Ft, Gs^Ft, Gs^Fds, Gs^Ft, Gs^Ft, Gs^Ft, Gs^Fds, Gs^Ft, Gs^Ft, Ww, Gs^Ft, Gs^Ft, Gs^Ft, Gs^Ft, Gs^Fds, Gs^Fds, Gs^Fds, Gs^Ft, Gs^Ft, Gll^Ftr, Rp, Rp, Rp, Gs^Fds, Gs^Ft, Gs^Ft, Gs^Efm, Gs^Ft, Gs^Ft, Gs^Ft, Rp, Rp, Rp, Rp, Gg, Rp, Ss, Rp, Rp, Rp, Hh, Rp, Ss, Ss, Ww, Wwt^Bsb|, Ww, Ss, Ss, Ds, Dd^Ftd, Gd, Hhd, Hhd, Hhd, Rr, Gs, Gd^Fts, Mdd, Dd, Dd
Gll^Ftr, Gs^Fds, Gs^Fds, Gll^Ftr, Gs^Fds, Gs^Fds, Gll^Ftr, Gll^Ftr, Gs^Ft, Ww, Ww, Gs^Fds, Gs^Ft, Gs^Fds, Gs^Fds, Gs^Ft, Gs^Fms, Gs^Ft, Rp, Rp, Rp, Gs^Gvs, Rp, Gs^Gvs, Gs^Fds, Gs^Efm, Gs, Hh, Rp, Rp, Ss, Ss, Ww, Ww, Ww, Ww^Bsb|, Ww, Hh, Hh, Hh, Ww, Ss, Ww, Ww, Rrc, Kd, Cd, Ww^Ewl, Wo, Ww^Ewf, Ww, Ss, Chs, Khr, Rp, Rr, Rr, Rr, Rr, Dd, Dd
Gll^Ftr, Gll^Ftr, Gll^Ftr, Gll^Ftr, Gll^Ftr, Gll^Ftr, Gll^Ftr, Gll^Ftr, Gs^Fms, Gs^Fds, Gg^Fet, Ww, Gs^Ft, Gs^Fds, Gg^Efm, Gs^Fds, Gll^Ftr, Rp, Gs^Emf, Re^Gvs, Rp, Gs^Fds, Rp, Gs^Ft, Rp, Rp, Rp, Rp, Gg^Efm, Gg, Ss, Ww, Ww, Ww, Cd, Ww^Bsb|, Ww, Ww, Wwt, Ww, Ss, Ww, Ww, Cd, Wo, Wwt^Bsb|, Wo, Ww^Bsb\, Cd, Wo, Wo, Ww, Ww, Ss, Ww^Bsb|, Ss, Hhd, Hhd, Hhd, Rr, Rr
Gll^Ftr, Gs^Fds, Gll^Ftr, Gll^Ftr, Gll^Ftr, Gg^Efm, Gs^Fds, Gs^Fds, Gll^Ftr, Gs^Fms, Ds, Ww, Gll^Ftr, Gs^Ft, Gs^Fds, Gs^Fds, Gs^Ft, Rp, Rp, Rb^Gvs, Rb^Gvs, Rp, Rp, Rp, Ss, Khr, Hh, Hhd, Gg, Ds, Ww, Ww, Ww, Kd, Rrc, Rrc, Rp, Ww, Ss, Hh, Hh, Ss, Ww, Wo, Gg, Rrc, Ww^Bsb\, Wo, Wo, Ww^Bsb\, Rrc, Ww, Ww, Wo, Ww^Bsb|, Ww, Ww, Ww, Ww, Mm, Gd^Fts
Gs^Fds, Gs^Fds, Gs^Fds, Gll^Ftr, Gs^Fds, Gs^Fds, Gs^Fds, Gs^Fds, Gs^Ft, Gs^Ft, Gs^Fds, Ww, Ds, Gs^Ft, Gs^Ft, Gs^Fds, Rp, Rp, Rd, Gs^Fds, Dd^Ftd, Ss, Rp, Gg^Efm, Ss, Chs, Hh, Hh, Gg, Ds^Fp, Ww, Ww, Ss, Cd, Rrc, Rr, Rr, Dd^Ftd, Ss, Gg^Efm, Gg^Efm, Hh, Hh, Ww, Ww, Rb^Gvs, Ww, Rrc, Rb^Gvs, Gg, Ww, Ww^Bsb\, Rrc, Kv, Rrc, Ss, Ss, Hh, Mm, Ww, Ww
Gll^Ftr, Gll^Ftr, Gll^Ftr, Gll^Ftr, Gll^Ftr, Gll^Ftr, Gll^Ftr, Gs^Ft, Gs^Em, Gs^Ft, Gs^Fds, Ww, Ww, Gs^Fds, Rp, Rp, Ss, Gg^Efm, Hh, Ww^Bw\, Ww^Ewf, Ww, Ww^Bsb|, Ww, Ss, Ss, Ds, Dd^Ftd, Ds, Ds, Ww, Ww, Dd^Ftd, Rrc, Rb^Gvs, Rr, Rb^Gvs, Rb^Gvs, Ss, Ss, Gd^Fts, Dd^Gvs, Ww, Ww, Hh, Ww, Ds, Ww^Bsb|, Ww, Ww, Rrc, Dd^Ftd, Rrc, Rrc, Hh, Hh, Mm, Hh, Mm, Mm, Gd^Fts
Gll^Ftr, Gs^Ft, Gs^Fds, Gll^Ftr, Gs^Fds, Gll^Ftr, Gs^Fds, Gs^Ft, Gs^Ft, Gs^Ft, Hh, Hh, Rp, Ww^Bsb/, Ww, Ds, Ww, Hh, Ww, Ww, Ww, Ww, Ww^Bsb|, Ww, Ww, Ww, Ww, Ww, Ww, Ww, Ww, Ww, Rrc, Rrc, Rb^Gvs, Mm, Ds^Fts, Hh, Ss, Hh, Ds^Fts, Hh, Ww, Hh, Hh, Gs, Rrc, Rrc, Rrc, Rrc, Hh, Rrc, Hh, Rr, Hh, Hh, Mm, Md^Xm, Md^Xm, Gd^Efm, Mm
Gs^Fds, Gs^Fds, Gll^Ftr, Gs^Fds, Gs^Ft, Gs^Ft, Gs^Ft, Gll^Ftr, Gs^Ft, Mm, Rp, Rp, Ww, Ww, Wo, Ww, Ww, Ww, Ww, Ww, Ds, Gg, Rrc, Ss, Ss, Ww^Ewl, Ww, Ww, Gs^Efm, Ww, Gs, Ss, Rrc, Gg^Efm, Hh, Hh, Ds^Fts, Gg^Efm, Hh, Ss, Ss, Hh, Ww, Hh, Rrc, Rrc, Hh, Hh, Md, Md, Hh, Mm, Gs, Rr, Rr, Hh, Mm, Md^Xm, Md, Md, Hhd
Gll^Ftr, Gll^Ftr, Gs^Fds, Gll^Ftr, Gll^Ftr, Gs^Ft, Gs^Ft, Gll^Ftr, Rp, Rp, Ww, Wwr, Ww^Ewl, Wo, Ww, Ww, Ww, Wwr, Ds, Ss, Dd^Ftd, Gs^Ft, Rrc, Ss, Ss, Ds, Ss, Gs^Fms, Gs, Ss, Ss, Hh, Rrc, Hh, Gd^Fts, Hh, Gs^Ft, Gg, Hh, Gd^Fts, Ss, Ss, Wwt, Gs^Ft, Rrc, Hh, Md, Md, Mm, Mm, Md, Md, Mm, Mm, Rr, Mm, Mm, Mm, Hhd, Hhd, Dd
Gll^Ftr, Gs^Ft, Gs^Ft, Gs^Fds, Gll^Ftr, Gll^Ftr, Rp, Rr, Ww, Ww, Wo, Wwr, Wwr, Ww^Ewf, Ww^Bw\, Ss, Ss, Ds^Esd, Ds, Ss, Dd^Ftd, Gs^Ft, Rrc, Gg, Ss, Ss, Gs, Gd^Efm, Gs^Ft, Gs^Ft, Gg^Efm, Gg, Hh, Rrc, Gd^Fts, Gs^Efm, Gd^Fts, Rb^Gvs, Gg, Gd^Fts, Gg, Gd^Fts, Hh, Wwt, Rrc, Hh, Md, Md, Mm, Gll^Ftr, Md^Xm, Md^Xm, Mm, Rr, Hh, Hh, Mm, Md, Hhd, Hd, Gd
Gll^Ftr, Gs^Ft, Gs^Ft, Gll^Ftr, Rp, Rp, Ww, Ww^Bsb\, Wo^Bsb\, Wo, Ww, Ww, Kd, Cd, Ss, Ds, Rp, Rb^Gvs, Hd, Dd^Ftd, Dd^Ftd, Gs^Ft, Rrc, Rrc, Rrc, Gs, Dd^Ftd, Gs^Ft, Gg, Gs^Ft, Hh, Hh, Dd^Ftd, Rrc, Dd^Ftd, Hh, Hh, Gg, Gg, Gd^Fts, Gs^Ft, Dd^Ftd, Hh, Wwt, Ww^Bsb|, Wwt, Wwt, Md, Wwt, Wwt, Wwt, Md^Xm, Cud, Cud, Cud, Mm, Md^Xm, Md, Gll^Ftr, Hd, Gd
Gll^Ftr, Gll^Ftr, Rp, Rp, Ww, Ww, Wo, Wo, Ww, Ww^Bsb\, Rrc, Cd, Rrc, Rrc, Rrc, Rp, Rb^Gvs, Gs^Ft, Gs^Ft, Gs^Ft, Rrc, Rrc, Hh, Gs^Ft, Gs, Rrc, Rp, Rp, Gg, Rb^Gvs, Hh, Hh, Gd^Efm, Rrc, Hh, Gs^Ft, Hh, Rb^Gvs, Hh, Rp, Dd^Ftd, Gd^Fts, Dd^Ftd, Ds^Edp, Rrc, Md, Mm, Wwt, Md^Xm, Md^Xm, Mv, Ww^Ewf, Rr, Rr, Rr, Gs^Ft, Gs^Ft, Md^Xm, Md, Gd^Fts, Gd^Fts
Rp, Rp, Ww, Ww, Wo, Wo, Ww, Ww, Ds, Hh, Gs, Rrc, Rp, Rp, Gg^Efm, Rrc, Rrc, Gs^Ft, Rrc, Rrc, Gs^Efm, Gs^Ft, Gs^Ft, Gs^Efm, Gs^Ft, Rrc, Gs^Ft, Rb^Gvs, Gs^Ft, Gd^Fts, Hh, Gd^Fts, Hh, Rrc, Gd^Fts, Gs^Ft, Gd^Fts, Gd^Fts, Rr, Rp, Gs, Gs^Efm, Gs^Efm, Hh, Rrc, Gs, Md, Md, Gll^Ftr, Mm, Mm, Mm, Rr, Rr, Rr, Rr, Hh, Md^Xm, Md, Hhd, Gd
Rp, Ds, Wo, Wo, Ww, Ww, Ss, Ss, Ss, Gs^Ft, Rb^Gvs, Rp, Rb^Gvs, Rb^Gvs, Gs^Ft, Gs^Ft, Gs^Ft, Rrc, Gs^Ft, Rrc, Rrc, Gs, Hh, Gs^Ft, Rrc, Rrc, Gs, Dd^Ftd, Gd, Gd^Fts, Gs^Ft, Hh, Gd, Rrc, Rrc, Gs, Gs, Dd^Ftd, Rrc, Dd^Ftd, Rrc, Rrc, Rrc, Rrc, Hh, Mm, Mm, Md^Xm, Mm, Gll^Ftr, Md^Xm, Mm, Kud, Rr, Cud, Gs^Ft, Gll^Ftr, Md^Xm, Gll^Ftr, Md, Gd
Ww, Ww, Ww, Ww, Ss, Ss, Gs^Ft, Gs^Ft, Gll^Ftr, Gll^Ftr, Rb^Gvs, Gll^Ftr, Dd^Ftd, Gs^Ft, Gs^Fds, Gll^Ftr, Gs^Ft, Gs^Ft, Gs^Ft, Gs^Ft, Gs^Ft, Rrc, Rrc, Gs, Rrc, Gd^Fts, Gs^Ft, Dd^Ftd, Gs^Ft, Hh, Gs^Ft, Gd^Fts, Hh, Gs, Gs^Efm, Rrc, Rrc, Rrc, Dd^Ftd, Rrc, Dd^Ftd, Dd^Ftd, Gs^Ft, Hh, Mm, Md, Mm, Gs^Ft, Mm, Md^Xm, Gll^Ftr, Gll^Ftr, Hh, Cud, Hh, Mm, Md^Xm, Md^Xm, Gll^Ftr, Gd^Fts, Gd^Fts
Wo, Wo, Ww, Ds, Gll^Ftr, Gll^Ftr, Gll^Ftr, Gll^Ftr, Hh, Gs^Ft, Dd^Ftd, Gs^Ft, Gs, Gs^Ft, Gll^Ftr, Gs^Ft, Gs^Ft, Gs^Ft, Gll^Ftr, Gs^Ft, Gs^Ft, Gs^Ft, Rrc, Rrc, Rrc, Gd^Fts, Gd^Fts, Gs^Ft, Gd^Fts, Hh, Hh, Gs, Gd^Fts, Gs, Rrc, Rrc, Gs, Rrc, Rrc, Ch, Gs, Gd^Gvs, Gs^Gvs, Gs, Hh^Fp, Gs^Ft, Mm, Md^Xm, Gs^Ft, Mm, Mm, Hh, Mm, Rr, Rr, Gll^Ftr, Md, Mm, Md^Xm, Gll^Ftr, Gd
Wo, Ww, Gll^Ftr, Gll^Ftr, Gll^Ftr, Gll^Ftr, Gll^Ftr, Gll^Ftr, Gll^Ftr, Hh, Gs^Ft, Hh, Gs^Ft, Gll^Ftr, Gs^Ft, Gs^Fds, Gs^Ft, Gll^Ftr, Gs^Ft, Rb^Gvs, Rr, Gs^Ft, Rr, Dd^Ftd, Rrc, Gs^Efm, Gs^Ft, Gs^Ft, Gs^Efm, Gs, Rrc, Rrc, Rrc, Rrc, Ds, Dd^Ftd, Kh, Ch, Rr, Rrc, Rrc, Ch, Kh, Gd^Gvs, Gs^Ft, Gs^Ft, Mm, Mm, Gs^Ftp, Gll^Ftr, Gs^Ftp, Gll^Ftr, Gll^Ftr, Mm, Mm, Rr, Rr, Md, Md, Md, Hhd
Ww, Ds, Gll^Ftr, Gll^Ftr, Gll^Ftr, Gll^Ftr, Gll^Ftr, Md^Xm, Mm^Xm, Gll^Ftr, Gll^Ftr, Hh, Dd^Ftd, Gs, Gs^Ft, Gll^Ftr, Gll^Ftr, Dd^Ftd, Gll^Gvs, Rr, Rr, Rr, Rr, Kd, Dd^Ftd, Rrc, Rrc, Hh, Rrc, Rrc, Ds, Ds^Edp, Dd^Ftd, Ds, Wwt, Ww, Ch, Rr, Rr, Rr, Rr, Rrc, Ch, Gs^Ft, Hh, Gd^Fts, Gs^Ft, Gs^Ft, Mm, Mm, Mm, Md^Xm, Ww^Ewf, Gll^Ftr, Mm, Mm, Mm, Rr, Rr, Hhd, Rr
Ss, Ss, Gll^Ftr, Gll^Ftr, Gll^Ftr, Gll^Ftr, Gll^Ftr, Gll^Ftr, Gll^Ftr, Gll^Ftr, Gll^Ftr, Gll^Ftr, Wwt, Wwt, Wwt, Ds, Dd, Dd^Ftd, Dd^Ftd, Rr, Rr, Rr, Rr, Cd, Ww, Ww^Ewf, Rrc, Rrc, Dd^Ftd, Ds, Ww, Ww, Ww, Ww, Ww, Ww, Ww, Ww^Bw/, Wwt^Bw/, Rr, Ch, Rrc, Rrc, Hh, Hh, Gd^Fts, Gs^Ft, Gs^Ft, Gs^Ft, Mm, Rrc, Mm, Rrc, Gll^Ftr, Rrc, Rrc, Rrc, Rr, Rr, Rr, Gd^Fts
Gll^Ftr, Gll^Ftr, Gs^Ft, Gll^Ftr, Gll^Ftr, Gll^Ftr, Hh, Gll^Ftr, Wwt, Hh, Hh, Wwt, Dd^Ftd, Gs^Ft, Ds, Wwt, Hd, Ds^Edp, Dd^Ftd, Rb^Gvs, Dd^Ftd, Ds, Ww, Ww^Bw\, Ww, Ww, Wwt^Bsb|, Ww, Ww, Ww, Ww, Ww, Ww, Ww, Wo, Ww, Ww, Ww, Ww, Ww, Dd^Ftd, Dd^Ftd, Gs, Rrc, Rrc, Gs, Rrc, Md, Rrc, Rrc, Mm, Rrc, Mm, Rrc, Hh^Fp, Hh^Fp, Hh^Fp, Mm, Rr, Hhd, Hhd
Gll^Ftr, Gs^Ft, Gs^Ft, Gll^Ftr, Md^Xm, Gll^Ftr, Wwt, Wwt, Gll^Ftr, Wwt, Wwt, Wwt, Gs^Ft, Dd^Ftd, Gll^Ftr, Wwt, Wwt, Wwt, Wwt, Wwt, Wwt, Wwt, Ds, Ww, Ww, Dd^Ftd, Rrc, Ww, Ww, Ww, Ww, Ww, Wo, Wo, Wo, Wo, Wo, Ww, Ww, Ww, Wwt, Dd, Hhd, Hhd, Rrc, Rrc, Gs^Ft, Rrc, Md, Mm, Mm, Mm, Md, Md, Hh^Fp, Hh^Fp, Hh^Fp, Mm, Rr, Hhd, Gll^Ftr
Gll^Ftr, Gs^Ft, Gll^Ftr, Gll^Ftr, Md^Xm, Gll^Ftr, Ww^Ewf, Gll^Ftr, Gs^Ft, Gll^Ftr, Gs^Ft, Gs^Ft, Gll^Ftr, Dd^Ftd, Dd^Ftd, Gs^Ft, Dd^Ftd, Dd^Ftd, Dd^Ftd, Gs^Ft, Gs^Efm, Gs^Ft, Dd^Ftd, Dd^Ftd, Dd^Ftd, Hd, Rrc, Ww, Ww, Ww, Wo, Wo, Wo, Wo, Wo, Wo, Wo, Wo, Wo, Ww, Ww, Dd^Ftd, Dd^Edp, Hhd, Rrc, Gs^Ft, Hh, Gs^Ft, Mm, Mm, Gs^Ft, Ww^Ewl, Gs^Ft, Md^Xm, Gs^Ft, Gs^Ft, Gs^Ft, Hhd, Rr, Gll^Ftr, Gd^Fts
Gll^Ftr, Gll^Ftr, Gll^Ftr, Hh, Gg^Bw/, Wwt, Mv, Gll^Ftr, Gll^Ftr, Gll^Ftr, Gll^Ftr, Gg, Gll^Ftr, Gs, Gll^Ftr, Gs^Ft, Gs^Ft, Gll^Ftr, Gs^Ft, Gs^Ft, Gll^Ftr, Gll^Ftr, Hd, Hd, Rrc, Rrc, Ww, Ww, Ww, Wo, Wo, Wo, Wo, Wo, Wo, Wo, Wo, Wo, Wo, Wo, Wo, Ww, Ww, Dd^Ftd, Rrc, Gd^Fts, Gs^Ft, Gd^Fts, Gs^Ft, Md^Xm, Md, Md^Xm, Gll^Ftr, Gll^Ftr, Md, Md^Xm, Md, Gll^Ftr, Rr, Gd^Fts, Gd^Fts
Gll^Ftr, Gll^Ftr, Gll^Ftr, Hh, Gg^Fet, Mm, Mm, Mm, Gll^Ftr, Gll^Ftr, Gll^Ftr, Gll^Ftr, Gll^Ftr, Gs^Ft, Gs^Ft, Gs^Ft, Gll^Ftr, Gll^Ftr, Gll^Ftr, Gs^Ft, Gll^Ftr, Dd^Ftd, Hd, Rrc, Hd, Ds^Edpp, Ww, Ww, Wo, Wo, Wo, Wo, Wo, Wo, Wo, Wo, Wo, Wo, Ds, Wo, Wo, Wo, Wo, Ww, Ww, Rrc, Rrc, Gd^Fts, Md, Md, Md, Md, Gll^Ftr, Md^Xm, Gll^Ftr, Gll^Ftr, Gll^Ftr, Md^Xm, Hhd, Rr, Hhd
Gll^Ftr, Gs^Ft, Cv, Kv, Cv, Gg^Efm, Md^Xm, Mm, Gll^Ftr, Gll^Ftr, Gll^Ftr, Gll^Ftr, Gs^Ft, Gs, Gs^Ft, Gll^Ftr, Gs^Ft, Gs^Ft, Gs^Ft, Gs^Ft, Hh, Hhd, Hd, Rrc, Hd, Ds, Ww, Ww, Wo, Wo, Wo, Wo, Wo, Wo, Wo, Wo, Wo, Wo, Wo, Kv, Wo, Cd, Kd, Wo, Wo, Ww, Rrc, Gs^Ft, Gd^Fts, Gs^Ft, Wwt, Hh, Ww^Ewf, Md, Gll^Ftr, Gll^Ftr, Gll^Ftr, Mm, Hhd, Rr, Hhd
Gs^Ft, Cv, Cv, Cv, Cv, Cv, Gll^Ftr, Gll^Ftr, Gs^Ft, Gs^Ft, Gs^Ft, Gll^Ftr, Gs^Ft, Gs^Ft, Gll^Ftr, Gs, Gs^Ft, Dd, Gs^Ft, Gs^Efm, Rrc, Rrc, Rrc, Rrc, Dd^Ftd, Hd, Wwt, Ww, Wo, Wo, Wo, Wo, Wo, Wo, Wo, Wo, Wo, Wo, Cv, Wo^Bsb|, Wo^Bsb/, Wo^Bsb/, Wo, Wo, Wo, Ww, Rrc, Hh, Wwt, Wwt, Wwt, Wwt, Ww^Ewl, Wwt, Wwt, Md, Md, Mm^Xm, Mm^Xm, Rr, Gd^Fts
Gll^Ftr, Gs^Ft, Gs^Ft, Cv, Gll^Ftr, Gll^Ftr, Gll^Ftr, Gll^Ftr, Gs^Ft, Gs^Ft, Gs^Ft, Gll^Ftr, Gll^Ftr, Gs^Ft, Gs, Gll^Ftr, Dd, Gll^Ftr, Rrc, Rrc, Ds, Ds^Edp, Dd^Ftd, Ds, Hd, Ww, Ww, Ww, Wo, Wo, Wo, Wo, Wo, Wo, Wo, Wo, Wo, Wo, Kv, Rrc, Cv, Wo, Wo, Wo, Wo, Ww, Ww, Ww^Bsb\, Wwt^Bsb\, Kd, Rrc, Wwt^Bw|, Rrc, Kd, Md^Xm, Wwt, Wwt, Wwt, Mm^Xm, Rr, Gd^Fts
Gll^Ftr, Gll^Ftr, Gll^Ftr, Gs^Ft, Gs^Ft, Gll^Ftr, Gll^Ftr, Gll^Ftr, Gll^Ftr, Gs^Ft, Gll^Ftr, Gll^Ftr, Gll^Ftr, Gs^Ft, Gs^Ft, Dd^Edp, Rrc, Rrc, Ds, Ds, Ww, Ww, Hd, Ww, Ww, Ww, Wo, Wo, Wo, Wo, Wo, Wo, Wo, Wo, Wo, Wo, Wo, Wo, Rrc, Rrc, Rrc, Kv, Wo, Wo, Wo, Ww, Ww, Ww, Rrc, Cd, Rrc, Rrc, Rrc, Cd, Mv, Mm, Mm, Mm^Xm, Md, Rr, Hhd
Gll^Ftr, Gll^Ftr, Gll^Ftr, Gll^Ftr, Gs^Ft, Gll^Ftr, Gll^Ftr, Gll^Ftr, Gll^Ftr, Gll^Ftr, Gll^Ftr, Gll^Ftr, Gll^Ftr, Gll^Ftr, Gll^Ftr, Rrc, Ds, Ds, Ww, Ww, Ww, Ww, Ww, Ww, Wo, Ww, Wo, Wo, Wo, Wo, Wo, Wo, Wo, Wo, Wo, Wo, Wo, Wo^Bw/, Rrc, Gg^Fet, Rrc, Cv, Wo, Wo, Wo, Ww, Ww, Rrc, Gg^Fet, Cd, Cd, Kd, Cd, Cd, Rb^Gvs, Hh^Efm, Hh^Efm, Hh^Efm, Hh^Efm, Rr, Hhd
Md^Xm, Gll^Ftr, Gs^Ft, Gs^Ft, Gll^Ftr, Gll^Ftr, Gll^Ftr, Gll^Ftr, Gll^Ftr, Gll^Ftr, Gll^Ftr, Gll^Ftr, Gll^Ftr, Gll^Ftr, Rrc, Rrc, Ds, Ww, Ww, Ww, Wo, Wo, Ww, Wo, Wo, Wo, Wo, Wo, Wo, Wo, Wo, Wo, Wo, Wo, Wo, Wo, Wo, Wo^Bw/, Cv, Rrc, Cv, Rrc, Wo^Bsb\, Wo, Wo, Ww, Ww, Rrc, Hh, Gs^Ftp, Rb^Gvs, Cd, Rb^Gvs, Gg^Fet, Rb^Gvs, Gs^Ftp, Gs^Ft, Gs^Ft, Rr, Rr, Gd^Fts
Md^Xm, Md^Xm, Gs^Ft, Gs^Ft, Gll^Ftr, Gll^Ftr, Gll^Ftr, Gll^Ftr, Gll^Ftr, Gs^Ft, Gs^Ft, Gll^Ftr, Gll^Ftr, Gll^Ftr, Rrc, Ds^Edp, Dd^Ftd, Ww, Ww, Wo, Wo, Wo, Wo, Wo, Wo, Wo, Wo, Wo, Wo, Wo, Wo, Wo, Wo, Wo, Wo, Wo, Wo, Wo, Wo, Kv, Wo, Wo, Wo, Wo^Bsb\, Ww^Bsb\, Ww, Ds^Edpp, Rrc, Mm, Mm, Gs^Ftp, Gs^Ftp, Rb^Gvs, Md^Xm, Md^Xm, Mm, Mm, Rr, Hhd, Hhd, Gd^Fts
Md^Xm, Kv, Gll^Ftr, Gs^Ft, Gs^Ft, Gll^Ftr, Gll^Ftr, Gll^Ftr, Gll^Ftr, Gs^Ft, Gs^Ft, Gll^Ftr, Gll^Ftr, Gs^Ft, Rrc, Ds, Ww, Ww, Ww, Wo, Wo, Wo, Wo, Wo, Wo, Wo, Wo, Wo, Wo, Wo, Wo, Wo, Wo, Wo, Wo, Wo, Wo, Wo, Wo, Wo, Wo, Wo, Wo, Wo, Ww, Rrc, Rrc, Rrc, Rrc, Mm, Md, Md^Xm, Gll^Ftr, Mm, Gs^Ft, Gs^Ft, Gs^Ft, Rr, Hhd, Gd^Fts, Gs^Ft
Md^Xm, Gg, Gll^Ftr, Gll^Ftr, Gs^Ft, Gll^Ftr, Gll^Ftr, Gll^Ftr, Gll^Ftr, Gll^Ftr, Gll^Ftr, Dd^Ftd, Dd, Rrc, Ds, Dd, Ww, Ww, Ww, Wo, Wo, Wo, Wo, Wo, Wo, Wo, Wo, Wo, Wo, Wo, Wo, Wo, Wo, Wo, Wo, Wo, Wo, Wo, Wo, Wo, Wo, Wo, Wo, Wo, Ww, Ds, Rrc, Hh, Hh, Rrc, Rrc, Mm, Mm, Mm, Mm, Mm, Rr, Rr, Hhd, Gd^Fts, Gd^Fts
Gll^Ftr, Gll^Ftr, Gll^Ftr, Gll^Ftr, Gs^Ft, Gll^Ftr, Gll^Ftr, Gll^Ftr, Gll^Ftr, Wwt, Wwt, Wwt, Wwt, Wwt^Bsb|, Wwt, Wwt, Wwt, Ww, Wo, Wo, Wo, Wo, Wo, Wo, Wo, Wo, Wo, Wo, Wo, Wo, Wo, Wo, Wo, Wo, Wo, Wo, Wo, Wo, Wo, Wo, Wo, Wo, Wo, Ww, Mm, Dd^Ftd, Rrc, Gs^Ft, Gg^Fet, Rr, 1 Ket, Rrc, Rrc, Mm, Rrc, Rrc, Rr, Hh, Hhd, Gd^Fts, Gd^Fts
Gll^Ftr, Gll^Ftr, Gs^Ft, Gs^Ft, Gs^Ft, Gs^Ft, Gll, Gll, Ce, Gll^Ftr, Gll^Ftr, Gll^Ftr, Rrc, Rrc, Wwt, Wwt, Ww, Wo, Wo, Wo, Wo, Wo, Wo, Wo, Wo, Wo, Wo, Wo, Wo, Wo, Wo, Wo, Wo, Wo, Wo, Wo, Wo, Wo, Wo, Wo, Wo, Wo, Wo, Ww, Mm, Hh, Rrc, Gs^Ft, Rp, Rp, Rp, Ce, Ket, Rrc, Md, Md, Md, Rr, Rr, Hhd, Gd^Fts
Gll^Ftr, Gs^Ft, Gs^Ft, Gll^Ftr, Gll^Ftr, Gll, Rp, Rp, Ce, Ke, Rrc, Rrc, Ds, Ds, Ww, Ww, Ww, Wo, Wo, Wo, Wo, Wo, Wo, Wo, Wo, Wo, Wo, Wo, Wo, Wo, Wo, Wo, Wo, Wo, Wo, Wo, Wo, Wo, Wo, Wo, Wo, Wo, Wo, Ww, Hh, Hh, Rrc, Gll^Ftr, Gll^Ftr, Rb^Gvs, Rp, Rb^Gvs, Gg^Fet, Mm, Md, Md, Md, Hh, Hhd, Rr, Hhd
Gll^Ftr, Gs^Ft, Gs^Ft, Gll^Ftr, Gll^Ftr, Gll^Ftr, Gll^Ftr, Ce, Rrc, Rrc, Ds, Ds, Ww, Ww, Ww, Ww, Wo, Wo, Wo, Wo, Wo, Wo, Wo, Wo, Wo, Wo, Wo, Wo, Wo, Wo, Wo, Wo, Wo, Wo, Wo, Wo, Wo, Wo, Wo, Wo, Wo, Wo, Wo, Ww, Mm, Rrc, Hh, Hh, Mm, Mm, Md, Md, Gll^Ftr, Mm, Md, Md, Md, Gs^Ft, Gd^Fts, Rr, Hhd
Gll^Ftr, Gs^Ft, Gll^Ftr, Gll^Ftr, Gll^Ftr, Gs^Ft, Rrc, Rrc, Ds, Ds, Ww, Ww, Ww, Ww, Wo, Wo, Wo, Wo, Wo, Wo, Wo, Wo, Wo, Wo, Wo, Wo, Wo, Wo, Wo, Wo, Wo, Wo, Wo, Wo, Wo, Wo, Wo, Wo, Wo, Wo, Wo, Wo, Wo, Ww, Ds, Rrc, Hh, Gs^Ft, Gs^Ft, Gs^Ft, Mm, Md^Xm, Gll^Ftr, Md^Xm, Mm, Md, Md, Gs^Ft, Gd^Fts, Rr, Gd^Fts
Rrc, Gs^Ft, Gs^Ft, Gll^Ftr, Gll^Ftr, Gll^Ftr, Rrc, Dd^Ftd, Ww, Ww, Ww, Ww, Wo, Wo, Wo, Wo, Wo, Wo, Wo, Wo, Wo, Wo, Wo, Wo, Wo, Wo, Wo, Wo, Wo, Wo, Wo, Wo, Wo, Wo, Wo, Wo, Wo, Wo, Wo, Wo, Wo, Wo, Wo, Ww, Ds, Rrc, Rrc, Hh, Mm, Mm, Md^Xm, Gll^Ftr, Mv, Gll^Ftr, Gll^Ftr, Md^Xm, Md, Md, Hhd, Rr, Gd^Fts
Gll^Ftr, Gll^Ftr, Gll^Ftr, Gg^Efm, Rrc, Rrc, Ds, Ds, Ww, Ww, Wo, Wo, Wo, Wo, Wo, Wo, Wo, Wo, Wo, Wo, Wo, Wo, Wo, Wo, Wo, Wo, Wo, Wo, Wo, Wo, Wo, Wo, Wo, Wo, Mm, Wo, Mm, Wo, Ww, Wo, Ww, Wo, Ww, Ww, Mm, Mm, Mm, Rrc, Rrc, Mm, Mm, Mm, Mm, Mm, Mm, Mm, Mm, Md, Rr, Rr, Hhd
Gll^Ftr, Gll^Ftr, Rrc, Rrc, Hd, Hd, Ds, Ww, Ww, Wo, Wo, Wo, Wo, Wo, Wo, Wo, Wo, Wo, Wo, Wo, Wo, Wo, Wo, Wo, Wo, Wo, Wo, Wo, Wo, Wo, Wo, Wo, Mm, Mm, Mm, Mm, Mm, Mm, Dd^Ftd, Ww, Ds, Ww, Mm, Ww, Dd^Ftd, Mm, Mm, Mm, Mm, Rrc, Mm, Mm, Rrc, Rrc, Rrc, Mm, Mm, Hh, Rr, Hhd, Gd^Fts
Rrc, Rrc, Hd, Hd, Hd, Hd, Ww, Ww, Wo, Wo, Wo, Wo, Wo, Wo, Wo, Wo, Wo, Wo, Wo, Wo, Wo, Wo, Wo, Wo, Wo, Wo, Wo, Wo, Wo, Wo, Ww, Mm, Mm, Mm, Mm, Mm, Md^Xm, Hh, Hh, Ds, Hh, Ds, Mm, Hh, Mm, Mm, Mm, Mm, Rrc, Rrc, Mm, Gg^Efm, Rrc, Gg^Fet, Rrc, Gg^Efm, Mm, Rr, Hhd, Hhd, Gd^Fts
Ds, Ds, Ds, Dd^Ftd, Ww, Ww, Wo, Wo, Wo, Wo, Wo, Wo, Wo, Wo, Wo, Wo, Wo, Wo, Wo, Wo, Wo, Wo, Wo, Wo, Wo, Wo, Wo, Wo, Ww, Ww, Mm, Mm, Mm, Mm, Mm, Mm, Mm, Mm, Hh, Hh, Hh, Mm, Mm, Mm, Mm, Mm, Mm, Mm, Rrc, Mm, Mm, Mm, Rrc, Rrc, Cv, Mm, Rrc, Rr, Mm, Gll^Ftr, Gll^Ftr
Ww, Ww, Ww, Ww, Wo, Wo, Wo, Wo, Wo, Wo, Wo, Wo, Wo, Wo, Wo, Wo, Wo, Wo, Wo, Wo, Wo, Wo, Wo, Wo, Wo, Wo, Wo, Wo, Ww, Ds, Hh, Mm, Mm, Mm, Mm, Md^Xm, Mm, Mm, Mm, Hh, Mm, Mm, Mm, Mm, Mm, Mm, Rrc, Rrc, Mm, Rrc, Rrc, Cv, Cv, Kv, Mm, Rrc, Mm, Mm, Md^Xm, Gll^Ftr, Gll^Ftr
Wo, Ww, Wo, Wo, Wo, Wo, Wo, Wo, Wo, Wo, Wo, Wo, Wo, Wo, Wo, Wo, Wo, Wo, Wo, Wo, Wo, Wo, Wo, Wo, Wo, Wo, Wo, Wo, Ww, Ds, Hh, Mm, Mm, Mm, Mm, Md^Xm, Md^Xm, Mm, Md^Xm, Mm, Md^Xm, Md^Xm, Md^Xm, Mm, Mm, Rrc, Mm, Mm, Mm, Ms^Xm, Ms^Xm, Ms^Xm, Ms^Xm, Ms^Xm, Mm, Mm, Mm, Mm, Md^Xm, Gll^Ftr, Hhd
