border_size=1
usage=map

_off^_usr, _off^_usr, _off^_usr, _off^_usr, _off^_usr, _off^_usr, _off^_usr, _off^_usr, _off^_usr, _off^_usr, _off^_usr, _off^_usr, _off^_usr, _off^_usr, _off^_usr, _off^_usr, _off^_usr, _off^_usr, _off^_usr, _off^_usr, _off^_usr, _off^_usr, _off^_usr, _off^_usr, _off^_usr, _off^_usr, _off^_usr, _off^_usr, _off^_usr, _off^_usr, _off^_usr, _off^_usr, _off^_usr, _off^_usr, _off^_usr, _off^_usr, _off^_usr, _off^_usr, _off^_usr, _off^_usr, _off^_usr, _off^_usr, _off^_usr
_off^_usr, _off^_usr, _off^_usr, _off^_usr, _off^_usr, _off^_usr, _off^_usr, _off^_usr, _off^_usr, _off^_usr, _off^_usr, _off^_usr, _off^_usr, _off^_usr, _off^_usr, _off^_usr, _off^_usr, _off^_usr, _off^_usr, _off^_usr, _off^_usr, _off^_usr, _off^_usr, _off^_usr, _off^_usr, _off^_usr, _off^_usr, _off^_usr, _off^_usr, _off^_usr, _off^_usr, _off^_usr, _off^_usr, _off^_usr, _off^_usr, _off^_usr, _off^_usr, _off^_usr, _off^_usr, _off^_usr, _off^_usr, _off^_usr, _off^_usr
_off^_usr, _off^_usr, _off^_usr, _off^_usr, _off^_usr, _off^_usr, _off^_usr, _off^_usr, _off^_usr, _off^_usr, _off^_usr, _off^_usr, Mm^Xm, Mm^Xm, Mm^Xm, Ds^Fp, Mm^Xm, Ds^Fp, Hd^Gvs, Ds^Fms, Ww, Ww, Ww, Ds^Fp, Ds^Fms, Mm^Xm, Mm^Xm, Mm^Xm, Mm^Xm, Mm^Xm, Mm, _off^_usr, _off^_usr, _off^_usr, _off^_usr, _off^_usr, _off^_usr, _off^_usr, _off^_usr, _off^_usr, _off^_usr, _off^_usr, _off^_usr
_off^_usr, _off^_usr, _off^_usr, _off^_usr, _off^_usr, _off^_usr, _off^_usr, _off^_usr, _off^_usr, _off^_usr, Ds^Fp, Mm, Hd^Fms, Mm, Ds^Fp, Mm^Xm, Ds^Fms, Dd^Vda, Dd, Hd, Mm, Ww, Ds^Fp, Hd, Ds, Hd^Gvs, Dd^Vda, Hd^Fms, Hd, Mm, Hd, Ds^Fp, Dd, _off^_usr, _off^_usr, _off^_usr, _off^_usr, _off^_usr, _off^_usr, _off^_usr, _off^_usr, _off^_usr, _off^_usr
_off^_usr, _off^_usr, _off^_usr, _off^_usr, _off^_usr, _off^_usr, _off^_usr, _off^_usr, Hd, Dd, Ds, Hd, Ds, Hd^Gvs, Hd^Fds, Mm, Dd, Dd, Cd, Dd, Cd, 1 Kd, Cd, Dd, Cd, Ds, Ds, Hd^Uf, Ds, Ds, Dd, Dd, Mm, Wwf, Wwf, _off^_usr, _off^_usr, _off^_usr, _off^_usr, _off^_usr, _off^_usr, _off^_usr, _off^_usr
_off^_usr, _off^_usr, _off^_usr, _off^_usr, _off^_usr, _off^_usr, Wwf, Wwf, Dd, Dd, Ds, Ds, Dd, Dd^Vda, Dd, Dd, Dd, Dd, Kd, Cd, Dd, Wwf, Dd, Cd, Kd, Dd, Dd, Ds, Dd, Ds, Dd, Hd, Hd^Fms, Ds^Fds, Wwf, Xu, Xu, _off^_usr, _off^_usr, _off^_usr, _off^_usr, _off^_usr, _off^_usr
_off^_usr, _off^_usr, _off^_usr, _off^_usr, Xu, Xu, Wwf, Ss, Ss, Hd^Fms, Hd, Dd, Dd, Dd, Rd, Dd, Rd, Dd, Dd, Dd, Dd, Wwf, Dd, Dd, Dd, Dd, Dd, Dd, Dd, Ds, Ds^Uf, Dd, Ss, Ss, Dd, Wwf, Xu, Xu, Xu, _off^_usr, _off^_usr, _off^_usr, _off^_usr
_off^_usr, _off^_usr, Xu, Xu, Wwf, Wwf, Dd, Ss, Ds, Ds^Fp, Dd, Dd, Dd, Dd, Rd, Rd, Xu, Rd, Rd^Uf, Dd, Rd, Wwf, Dd, Ds^Fms, Dd, Rd, Rd, Rd, Xu, Ds, Ds, Chs, Rr^Vd, Ss, Rd, Wwf, Wwf, Xu, Uh, Xu, Xu, _off^_usr, _off^_usr
_off^_usr, _off^_usr, Xu, Xu, Wwf, Dd, Ds, Ds^Fp, Mm, Ds, Dd, Dd, Rd, Rd, Ww, Xu, Uh, Uu^Vud, Xu, Rd, Wwf, Wwf, Ss, Dd, Rd, Rd, Wwf, Xu, Xu, Uh, Ds, Rr, Rr, Hd^Fds, Ds, Rd, Wwf, Xu, Wwf, Uu, Uu^Uf, _off^_usr, _off^_usr
_off^_usr, _off^_usr, Xu, Wwf, Ds^Fp, Hd, Ds, Hd, Ds^Fp, Hd, Dd, Ss^Vhs, Ss, Ww, Wo, Ww^Ewf, Wwf, Wwf, Uh, Uu^Uf, Wwf, Ww, Ss^Vhs, Ss, Xu, Wwf, Ur, Ur, Rd, Ds^Fp, Dd, Ds, Ds, Ds, Ds, Rd, Rd^Uf, Wwf, Wwf, Uu, Xu, _off^_usr, _off^_usr
_off^_usr, _off^_usr, Wwf, Wwf, Ds, Dd, Ds, Rd^Uf, Ds, Ds, Dd, Ss, Rd, Ww, Ww, Ww, Xu, Uh, Xu, Ur, Ww, Ww, Ww, Xu, Ww, Uu^Vud, Ur, Rd, Dd, Dd, Dd, Dd, Rd^Uf, Ds, Ds^Fp, Ds, Rd, Ds^Fp, Wwf, Xu, Xu, _off^_usr, _off^_usr
_off^_usr, _off^_usr, Ds^Fms, Ds^Fp, Rd^Uf, Rd, Dd, Ds, Ds, Ds, Dd, Dd, Dd, Rd, Wwf, Uh, Xu, Ur, Xu, Wwf, Ww, Wo, Uu, Uh, Uh, Xu, Xu, Rd, Rd, Dd, Hd, Hd, Mm, Hd^Uf, Hd, Ds, Ds, Rd, Rd, Wwf, Xu, _off^_usr, _off^_usr
_off^_usr, _off^_usr, Mm, Hd, Rd, Rd, Dd, Ds, Hd, Ds, Ss, Dd, Hd, Rd, Wwf, Xu, Xu, Ur, Wwf, Wwf, Ww, Uu^Uf, Ww, Ww, Wwf, Uu^Uf, Xu, Uh, Wwf, Rd, Hd, Ds^Fms, Ss, Ds^Fp, Hd, Ds^Fms, Ds, Rd, Rd, Wwf, Wwf, _off^_usr, _off^_usr
_off^_usr, _off^_usr, Wwf, Rd^Uf, Rd, Dd, Dd, Ds^Fp, Hd, Ds^Fms, Mm, Ds^Fp, Hd, Rd, Rd, Uh, Xu, Uu^Uf, Uh, Ww, Uu, Uu^Uf, Ww, Wwf, Xu, Ur, Xu, Xu, Wwf, Rd, Dd, Dd, Dd, Ds, Ds, Ds, Ds, Dd, Dd, Rd^Uf, Mm, _off^_usr, _off^_usr
_off^_usr, _off^_usr, Xu, Wwf, Rd, Dd, Dd, Dd, Ds^Fp, Hd^Uf, Rd^Uf, Hd, Ds, Dd, Dd, Rd, Ur, Xu, Ww, Uh, Ww, Wo, Ww, Wwf, Xu, Ur, Xu, Uh, Ww, Rd, Rd, Dd, Dd, Dd, Dd, Ds, Dd, Dd, Hd, Hd, Ds^Fp, _off^_usr, _off^_usr
_off^_usr, _off^_usr, Xu, Wwf, Wwf, Ds^Fms, Dd^Uf, Dd, Dd, Ds, Ds, Ds, Ds, Dd, Rd, Rd, Ur, Uu^Vud, Xu, Xu, Ss^Vhs, Ww, Wwf, Ur, Uh, Uh, Wwf, Ww, Wo, Ww, Ss, Ss, Dd, Dd, Ds^Fms, Ds, Ds, Dd, Dd, Ds^Fp, Wwf, _off^_usr, _off^_usr
_off^_usr, _off^_usr, Xu, Xu, Wwf, Rd, Rd, Dd, Dd, Dd, Rr, Ds, Dd, Ds^Fp, Xu, Ur, Wwf, Wwf, Rd, Ss, Ss, Ww, Wwf, Uu^Uf, Xu, Wwf, Uh, Ww^Ewf, Ww, Ww, Rd, Ss^Vhs, Dd, Hd, Mm, Hd, Rd^Uf, Dd, Dd, Wwf, Xu, _off^_usr, _off^_usr
_off^_usr, _off^_usr, Uu^Uf, Uu, Wwf, Wwf, Wwf, Rd, Dd, Hd^Fds, Rr^Vd, Rr, Dd, Uh, Xu, Xu, Rd, Rd, Dd, Dd, Dd, Wwf, Rd, Rd, Rd^Uf, Uu^Vud, Xu, Xu, Rd, Rd, Dd, Dd, Dd, Ds, Ds, Ds^Fp, Dd, Dd, Wwf, Wwf, Xu, _off^_usr, _off^_usr
_off^_usr, _off^_usr, Xu, Wwf, Uh, Xu, Wwf, Rd, Rd, Ss, Ss, Chs, Dd^Uf, Dd, Dd, Rd, Dd, Rd, Dd, Ds^Fp, Dd, Wwf, Dd, Dd, Dd, Rd, Rd, Rd, Rd, Dd, Dd, Dd, Hd, Ds^Fp, Ss, Ss, Wwf, Wwf, Xu, Xu, Xu, _off^_usr, _off^_usr
_off^_usr, _off^_usr, _off^_usr, Xu, Xu, Xu, Xu, Wwf, Ss, Ss, Hd^Fms, Dd, Dd, Dd, Dd, Dd, Dd, Dd, Kd, Dd, Dd, Wwf, Dd, Dd, Kd, Dd, Dd, Dd, Dd, Dd, Dd, Dd, Ds, Hd^Fms, Ds, Ss, Wwf, Xu, Xu, Xu, _off^_usr, _off^_usr, _off^_usr
_off^_usr, _off^_usr, _off^_usr, _off^_usr, _off^_usr, Xu, Xu, Wwf, Wwf, Ds^Fds, Mm, Hd, Ds, Dd, Ds, Ds, Dd, Dd, Cd, Cd, Cd, Wwf, Cd, Cd, Cd, Dd, Dd, Dd, Hd^Fds, Dd^Vda, Ds, Ds, Ds, Ds, Dd, Wwf, Xu, Xu, _off^_usr, _off^_usr, _off^_usr, _off^_usr, _off^_usr
_off^_usr, _off^_usr, _off^_usr, _off^_usr, _off^_usr, _off^_usr, _off^_usr, Xu, Wwf, Dd, Dd, Ds^Fp, Ds, Ds, Hd, Hd^Uf, Dd^Vda, Dd, Dd, Hd, Mm, 2 Kd, Ds^Fp, Dd, Dd, Dd, Ds^Fp, Mm, Hd, Hd^Gvs, Hd^Fms, Hd, Ds^Fms, Dd, Wwf, Wwf, _off^_usr, _off^_usr, _off^_usr, _off^_usr, _off^_usr, _off^_usr, _off^_usr
_off^_usr, _off^_usr, _off^_usr, _off^_usr, _off^_usr, _off^_usr, _off^_usr, _off^_usr, _off^_usr, Wwf, Dd, Dd, Ds, Ds^Fp, Mm, Hd^Fms, Mm^Xm, Hd^Gvs, Ds^Fms, Dd^Fet, Hd, Ww, Hd, Hd, Ds^Fms, Dd^Vda, Hd^Gvs, Hd, Mm^Xm, Mm, Mm, Hd, Hd^Fms, Mm, _off^_usr, _off^_usr, _off^_usr, _off^_usr, _off^_usr, _off^_usr, _off^_usr, _off^_usr, _off^_usr
_off^_usr, _off^_usr, _off^_usr, _off^_usr, _off^_usr, _off^_usr, _off^_usr, _off^_usr, _off^_usr, _off^_usr, _off^_usr, Mm, Hd, Mm, Mm^Xm, Mm^Xm, Mm^Xm, Mm^Xm, Mm^Xm, Mm, Mm^Xm, Ww, Ww, Mm, Mm^Xm, Mm^Xm, Mm^Xm, Mm^Xm, Mm, Mm^Xm, Mm, Hd, _off^_usr, _off^_usr, _off^_usr, _off^_usr, _off^_usr, _off^_usr, _off^_usr, _off^_usr, _off^_usr, _off^_usr, _off^_usr
_off^_usr, _off^_usr, _off^_usr, _off^_usr, _off^_usr, _off^_usr, _off^_usr, _off^_usr, _off^_usr, _off^_usr, _off^_usr, _off^_usr, _off^_usr, Mm^Xm, _off^_usr, Mm, _off^_usr, Ds^Fp, _off^_usr, Mm^Xm, _off^_usr, Ww, _off^_usr, Ds^Fp, _off^_usr, Hd, _off^_usr, Ds^Fp, _off^_usr, Mm^Xm, _off^_usr, _off^_usr, _off^_usr, _off^_usr, _off^_usr, _off^_usr, _off^_usr, _off^_usr, _off^_usr, _off^_usr, _off^_usr, _off^_usr, _off^_usr
_off^_usr, _off^_usr, _off^_usr, _off^_usr, _off^_usr, _off^_usr, _off^_usr, _off^_usr, _off^_usr, _off^_usr, _off^_usr, _off^_usr, _off^_usr, _off^_usr, _off^_usr, _off^_usr, _off^_usr, _off^_usr, _off^_usr, _off^_usr, _off^_usr, _off^_usr, _off^_usr, _off^_usr, _off^_usr, _off^_usr, _off^_usr, _off^_usr, _off^_usr, _off^_usr, _off^_usr, _off^_usr, _off^_usr, _off^_usr, _off^_usr, _off^_usr, _off^_usr, _off^_usr, _off^_usr, _off^_usr, _off^_usr, _off^_usr, _off^_usr
