Xu, Xu, Xu, Xu, Xu, Xu, Xu, Xu, Xu, Xu, Xu, Xu, Xu, Xu, Xu, Xu, Xu, Xu, Xu, Xu, Xu, Xu, Xu, Xu, Xu, Xu, Xu, Xu, Xu
Xu, Xu, Xu, Xu, Xu, Xu, Xu, Xu, Xu, Xu, Xu, Xu, Xu, Xu, Xu, Xu, Xu, Xu, Xu, Xu, Xu, Xu, Xu, Xu, Xu, Xu, Xu, Xu, Xu
Xu, Xu, Xu, Xu, Xu, Xu, Xu, Xu, Xu, Xu, Xu, Xu, Xu, Xu, Xu, Xu, Xu, Xu, Xu, Xu, Xu, Xu, Xu, Xu, Xu, Xu, Xu, Xu, Xu
Xu, Xu, Xu, Xu, Xu, Xu, Xu, Xu, Xu, Xu, Xu, Xu, Xu, Xu, Qxu, Qxu, Qxu, Xu, Xu, Xu, Xu, Xu, Xu, Xu, Xu, Xu, Xu, Xu, Xu
Xu, Xu, Xu, Xu, Xu, Xu, Xu, Xu, Xu, Xu, Xu, Xu, Uu^Uf, Uh, Uu, Kdr, Rd, Uh, Uu^Uf, Xu, Xu, Xu, Xu, Xu, Xu, Xu, Xu, Xu, Xu
Xu, Xu, Xu, Xu, Xu, Xu, Xu, Xu, Wo, Xu, Uh, Xu, Gd, Gd^Efm, Gd, Gd, Rd, Rd, Rd, Uu, Xu, Xu, Xu, Xu, Uu, Xu, Xu, Xu, Xu
Xu, Xu, Xu, Xu, Uh, Xu, Uh, Wo, Wo, Ss, Ss^Vhs, Gs^Fp, Rd, Rd, Rd, Rd, Hd, Gd, Gd^Efm, Rd, Ds, Xu, Wo, Uh, Uu^Vhh, Rrc, Xu, Xu, Xu
Rrc, Rrc, Rrc, Rrc, Uu, Uu^Vhh, Ww, Ww, Gd^Efm, Gd, Ds, Gd, Gd^Efm, Gd, Hd, Gd^Fts, Dd^Ftd, Mdd, Rrc, Gd^Efm, Ds, Wo, Wo, Wo, Ww, Rrc, Rrc, Xu, Xu
Xu, Uh, 1 Kd, Cd, Rrc, Ww, Wwf, Wwf, Ss, Rrc, Wwf, Rrc, Rrc, Rrc, Ds, Ds, Wwf, Rrc, Hd, Ds, Wwf, Wwf, Dd^Ftd, Wwf, Mdd, Cd, 3 Kd, Xu, Uh
Xu, Xu, Cd, Cd, Mdd, Rrc, Rrc, Ww, Rrc, Chs, Wwf, Wwf, Wwf, Ww^Ewf, Wwf, Wwf, Wwf, Wwf, Wwf, Ss^Vhs, Ss, Rrc, Rrc, Gd^Efm, Rrc, Cd, Cd, Uh, Rrc
Xu, Xu, Rd, Gd^Gvs, Gd^Efm, Gd, Gd^Efm, Gd^Efm, Gd, Dd^Ftd, Hd^Efm, Ds^Gvs, Gd^Vc, Wwf, Hd, Ww^Ewl, Dd^Ftd, Dd^Ftd, Rd, Ds, Gd^Efm, Gd, Rd, Rrc, Dd^Vda, Rrc, Rrc, Rrc, Xu
Xu, Xu, Rd, Dd^Vda, Gd, Gd^Efm, Rd, Rd, Rd, Gd^Efm, Rd, Rd, Dd^Ftd, Hd, Mdd, Chs, Hd, Rd, Gd^Efm, Rd, Rd, Rd, Hd, Dd, Gd^Efm, Gd^Gvs, Rrc, Xu, Xu
Xu, Xu, Gd^Efm, Rd, Rd, Dd^Ftd, Hd, Rd, Gd, Rd, Gd, Rd, Rd, Rd, Rd, Ss, Ds, Ds, Gd^Vc, Gd^Efm, Gd, Dd, Ds, Dd, Rrc, Rrc, Qxu, Xu, Xu
Xu, Xu, Xu, Hd, Mdd, Dd^Ftd, Dd, Hd, Gd^Efm, Gd^Efm, Hd^Efm, Dd, Hd^Efm, Ds, Wwf, Wwf, Wwf, Ww^Ewl, Hd, Gd^Gvs, Rrc, Rrc, Wwf, Dd^Ftd, Ss, Uh, Qxu, Xu, Xu
Xu, Xu, Xu, Xu, Ww, Ds, Wo, Ds, Ds, Mdd, Gd^Fts, Rrc, Rrc, Rrc, Wo^Bw\, Wo, Rrc, Dd^Ftd, Gd^Fts, Rrc, Ds, Wo, Wo, Wwf, Ww, Xu, Xu, Xu, Xu
Xu, Xu, Qxu, Xu, Ss, Wwf, Wwf, Wo, Rrc, Rrc, Hd, Dd^Ftd, Wwf, Wo, Wwf, Rrc, Hd^Efm, Rrc, Hd^Efm, Mdd, Gd^Efm, Ds, Ds, Ds, Mdd, Xu, Xu, Xu, Xu
Xu, Xu, Qxu, Uh, Rrc, Dd^Ftd, Ds, Rrc, Gd^Efm, Gd^Efm, Gd^Vc, Ww^Ewl, Ds, Wwf, Rd, Ds, Rd, Dd, Gd^Efm, Gd, Gd^Efm, Hd, Hd, Dd^Ftd, Rd, Hd^Efm, Gd^Efm, Xu, Xu
Xu, Xu, Rrc, Rrc, Gd^Efm, Dd, Hd^Efm, Dd, Rd, Gd^Efm, Gd^Gvs, Ds, Hd, Ss, Mdd, Rd, Dd^Ftd, Rd, Rd, Rd, Rd, Rd, Rd, Dd^Ftd, Gd^Efm, Rd, Rd, Xu, Xu
Xu, Xu, Rrc, Gd^Gvs, Dd^Vda, Rd, Rd, Rd, Gd^Efm, Rd, Rd, Rd, Dd^Ftd, Chs, Hd, Hd^Efm, Gd^Vc, Rd, Hd, Gd^Efm, Gd^Efm, Rd, Gd, Gd, Gd^Efm, Dd^Vda, Rd, Xu, Xu
Rrc, Rrc, Cd, Rrc, Rrc, Rrc, Rrc, Gd, Ss, Ds, Wwf, Dd^Ftd, Wwf, Ww^Ewl, Wwf, Wwf, Wwf, Ds^Gvs, Wwf, Dd^Ftd, Rrc, Ds, Rrc, Gd^Efm, Mdd, Gd^Gvs, Cd, Xu, Xu
Uh, Uh, 4 Kd, Cd, Mdd, Gd^Efm, Dd^Ftd, Rrc, Wwf, Ss^Vhs, Hd, Wwf, Wwf, Wwf, Ds, Ww^Ewf, Rrc, Wwf, Wwf, Chs, Ss, Ww, Wwf, Rrc, Rrc, Cd, 2 Kd, Xu, Xu
Xu, Xu, Rrc, Cd, Ww, Wwf, Wo, Wwf, Ds, Dd^Ftd, Rrc, Rrc, Dd^Ftd, Ds, Hd, Rrc, Gd^Efm, Rrc, Ds, Rrc, Gd^Efm, Wwf, Ww, Ww, Uu, Cd, Rrc, Uh, Rrc
Xu, Xu, Xu, Rrc, Uu^Vhh, Wo, Wo, Wo, Ds, Gd^Efm, Gd^Efm, Mdd, Hd, Gd^Fts, Rd, Gd^Efm, Rd, Gd, Ss^Vhs, Gd, Wo, Ww, Uh, Uu^Vhh, Uh, Rrc, Xu, Rrc, Xu
Xu, Xu, Xu, Rrc, Uu, Uh, Xu, Xu, Xu, Rd, Rd^Efm, Gd, Rd, Rd, Gd, Rd, Gd, Gs^Fp, Uh, Ss, Wo, Wo, Xu, Xu, Xu, Xu, Xu, Xu, Xu
Xu, Xu, Xu, Xu, Xu, Xu, Xu, Xu, Xu, Uu, Uu^Uf, Rd, Rd, Gd^Efm, Uu, Gd^Efm, Uu^Uf, Xu, Xu, Xu, Xu, Xu, Xu, Xu, Xu, Xu, Xu, Xu, Xu
Xu, Xu, Xu, Xu, Xu, Xu, Xu, Xu, Xu, Xu, Xu, Uh, Qxu, Kdr, Qxu, Uh, Xu, Xu, Xu, Xu, Xu, Xu, Xu, Xu, Xu, Xu, Xu, Xu, Xu
Xu, Xu, Xu, Xu, Xu, Xu, Xu, Xu, Xu, Xu, Xu, Xu, Xu, Qxu, Xu, Xu, Xu, Xu, Xu, Xu, Xu, Xu, Xu, Xu, Xu, Xu, Xu, Xu, Xu
Xu, Xu, Xu, Xu, Xu, Xu, Xu, Xu, Xu, Xu, Xu, Xu, Xu, Xu, Xu, Xu, Xu, Xu, Xu, Xu, Xu, Xu, Xu, Xu, Xu, Xu, Xu, Xu, Xu
Xu, Xu, Xu, Xu, Xu, Xu, Xu, Xu, Xu, Xu, Xu, Xu, Xu, Xu, Xu, Xu, Xu, Xu, Xu, Xu, Xu, Xu, Xu, Xu, Xu, Xu, Xu, Xu, Xu
